,CustomerID,Recency,Frequency,Monetary,R,F,M,RFM,Loyalty
0,12346.0,325,2,0.0,4,4,4,12,Bronze
1,12347.0,2,182,4310.000000000001,1,1,1,3,Platinum
2,12348.0,75,31,1797.24,3,3,1,7,Diamond
3,12349.0,18,73,1757.5500000000002,2,2,1,5,Platinum
4,12350.0,310,17,334.40000000000003,4,4,3,11,Bronze
5,12352.0,36,95,1545.4100000000005,2,2,2,6,Diamond
6,12353.0,204,4,89.0,4,4,4,12,Bronze
7,12354.0,232,58,1079.3999999999999,4,2,2,8,Gold
8,12355.0,214,13,459.4,4,4,3,11,Bronze
9,12356.0,22,59,2811.43,2,2,1,5,Platinum
10,12357.0,33,131,6207.67,2,1,1,4,Platinum
11,12358.0,1,19,1168.06,1,3,2,6,Diamond
12,12359.0,7,251,6182.98,1,1,1,3,Platinum
13,12360.0,52,129,2662.06,3,1,1,5,Platinum
14,12361.0,287,10,189.89999999999998,4,4,4,12,Bronze
15,12362.0,3,274,5154.58,1,1,1,3,Platinum
16,12363.0,109,23,552.0,3,3,3,9,Gold
17,12364.0,7,85,1313.1000000000001,1,2,2,5,Platinum
18,12365.0,291,23,320.68999999999994,4,3,3,10,Silver
19,12367.0,4,11,168.89999999999998,1,4,4,9,Gold
20,12370.0,51,166,3541.94,3,1,1,5,Platinum
21,12371.0,44,63,1887.96,2,2,1,5,Platinum
22,12372.0,71,52,1298.0400000000002,3,2,2,7,Diamond
23,12373.0,311,14,364.6,4,4,3,11,Bronze
24,12374.0,25,33,742.93,2,3,2,7,Diamond
25,12375.0,2,18,455.42,1,3,3,7,Diamond
26,12377.0,315,77,1628.12,4,2,1,7,Diamond
27,12378.0,129,219,4008.62,3,1,1,5,Platinum
28,12379.0,81,41,850.29,3,3,2,8,Gold
29,12380.0,21,105,2720.56,2,1,1,4,Platinum
30,12381.0,4,91,1803.96,1,2,1,4,Platinum
31,12383.0,184,100,1839.3100000000002,4,1,1,6,Diamond
32,12384.0,28,30,566.16,2,3,3,8,Gold
33,12386.0,337,10,401.9,4,4,3,11,Bronze
34,12388.0,15,100,2780.6600000000003,1,1,1,3,Platinum
35,12390.0,79,32,549.84,3,3,3,9,Gold
36,12391.0,21,93,439.66,2,2,3,7,Diamond
37,12393.0,72,64,1582.6000000000001,3,2,2,7,Diamond
38,12394.0,63,27,1272.48,3,3,2,8,Gold
39,12395.0,15,159,2998.28,1,1,1,3,Platinum
40,12397.0,35,126,2409.9000000000005,2,1,1,4,Platinum
41,12398.0,45,85,1635.6599999999999,2,2,1,5,Platinum
42,12399.0,119,59,1108.65,3,2,2,7,Diamond
43,12401.0,303,5,84.3,4,4,4,12,Bronze
44,12402.0,323,11,225.6,4,4,4,12,Bronze
45,12403.0,49,6,409.7,2,4,3,9,Gold
46,12405.0,148,54,1710.3900000000003,4,2,1,7,Diamond
47,12406.0,22,108,3280.7500000000005,2,1,1,4,Platinum
48,12407.0,49,77,1708.1199999999997,2,2,1,5,Platinum
49,12408.0,32,113,2842.57,2,1,1,4,Platinum
50,12409.0,78,114,11056.93,3,1,1,5,Platinum
51,12410.0,301,28,681.0799999999999,4,3,2,9,Gold
52,12412.0,74,61,1226.88,3,2,2,7,Diamond
53,12413.0,66,40,694.1500000000001,3,3,2,8,Gold
54,12414.0,217,18,562.41,4,3,3,10,Silver
55,12415.0,24,778,123725.45000000001,2,1,1,4,Platinum
56,12417.0,3,198,3578.8,1,1,1,3,Platinum
57,12418.0,112,34,668.58,3,3,2,8,Gold
58,12420.0,63,29,600.3900000000001,3,3,3,9,Gold
59,12421.0,15,46,806.2700000000001,1,2,2,5,Platinum
60,12422.0,95,39,803.5599999999998,3,3,2,8,Gold
61,12423.0,0,126,1849.1100000000001,1,1,1,3,Platinum
62,12424.0,162,30,1760.9599999999996,4,3,1,8,Gold
63,12425.0,78,36,777.1999999999999,3,3,2,8,Gold
64,12426.0,194,30,582.73,4,3,3,10,Silver
65,12427.0,11,35,708.37,1,3,2,6,Diamond
66,12428.0,25,300,7877.2,2,1,1,4,Platinum
67,12429.0,9,97,3750.4,1,2,1,4,Platinum
68,12430.0,43,11,256.4,2,4,4,10,Silver
69,12431.0,35,239,6348.89,2,1,1,4,Platinum
70,12432.0,42,108,5059.319999999999,2,1,1,4,Platinum
71,12433.0,0,420,13375.87,1,1,1,3,Platinum
72,12434.0,84,54,765.1899999999999,3,2,2,7,Diamond
73,12435.0,79,36,7829.890000000001,3,3,1,7,Diamond
74,12436.0,99,16,509.01000000000005,3,4,3,10,Silver
75,12437.0,1,201,4896.66,1,1,1,3,Platinum
76,12438.0,14,98,2906.8500000000004,1,2,1,4,Platinum
77,12441.0,366,11,173.55,4,4,4,12,Bronze
78,12442.0,3,12,172.06,1,4,4,9,Gold
79,12444.0,21,177,5005.46,2,1,1,4,Platinum
80,12445.0,22,4,133.4,2,4,4,10,Silver
81,12446.0,57,58,1002.3100000000001,3,2,2,7,Diamond
82,12447.0,243,26,476.49,4,3,3,10,Silver
83,12448.0,44,22,449.4500000000001,2,3,3,8,Gold
84,12449.0,22,191,4067.2900000000004,2,1,1,4,Platinum
85,12450.0,156,8,197.88,4,4,4,12,Bronze
86,12451.0,10,355,8933.52,1,1,1,3,Platinum
87,12452.0,16,23,428.57,1,3,3,7,Diamond
88,12453.0,134,43,707.0899999999999,3,2,2,7,Diamond
89,12454.0,53,30,-5.684341886080802e-14,3,3,4,10,Silver
90,12455.0,73,90,2466.8599999999997,3,2,1,6,Diamond
91,12456.0,44,129,3153.89,2,1,1,4,Platinum
92,12457.0,58,68,1917.78,3,2,1,6,Diamond
93,12458.0,71,38,947.4,3,3,2,8,Gold
94,12461.0,94,35,826.88,3,3,2,8,Gold
95,12462.0,2,72,1124.0099999999998,1,2,2,5,Platinum
96,12463.0,46,88,1303.63,2,2,2,6,Diamond
97,12464.0,10,29,1212.05,1,3,2,6,Diamond
98,12465.0,7,51,733.89,1,2,2,5,Platinum
99,12468.0,143,40,724.04,3,3,2,8,Gold
100,12471.0,2,530,18705.52,1,1,1,3,Platinum
101,12472.0,30,391,6229.48,2,1,1,4,Platinum
102,12473.0,29,178,2837.73,2,1,1,4,Platinum
103,12474.0,17,455,7064.7699999999995,2,1,1,4,Platinum
104,12475.0,53,36,723.3799999999999,3,3,2,8,Gold
105,12476.0,1,264,6546.58,1,1,1,3,Platinum
106,12477.0,22,308,13117.01,2,1,1,4,Platinum
107,12478.0,3,36,680.9900000000001,1,3,2,6,Diamond
108,12479.0,3,35,477.29999999999995,1,3,3,7,Diamond
109,12480.0,28,154,3281.6299999999997,2,1,1,4,Platinum
110,12481.0,22,217,5574.36,2,1,1,4,Platinum
111,12483.0,17,81,2327.13,2,2,1,5,Platinum
112,12484.0,32,347,4480.870000000001,2,1,1,4,Platinum
113,12488.0,9,55,1298.6600000000003,1,2,2,5,Platinum
114,12489.0,336,15,334.92999999999995,4,4,3,11,Bronze
115,12490.0,5,245,5417.93,1,1,1,3,Platinum
116,12491.0,38,26,460.40000000000003,2,3,3,8,Gold
117,12492.0,63,20,263.21,3,3,4,10,Silver
118,12493.0,165,23,416.79,4,3,3,10,Silver
119,12494.0,9,84,1139.35,1,2,2,5,Platinum
120,12497.0,81,14,1043.1,3,4,2,9,Gold
121,12498.0,21,23,403.7,2,3,3,8,Gold
122,12500.0,23,65,4206.27,2,2,1,5,Platinum
123,12501.0,315,160,2089.68,4,1,1,6,Diamond
124,12502.0,95,147,3723.87,3,1,1,5,Platinum
125,12503.0,337,1,-1126.0,4,4,4,12,Bronze
126,12504.0,18,15,114.00000000000003,2,4,4,10,Silver
127,12505.0,301,1,-4.5,4,4,4,12,Bronze
128,12506.0,232,23,73.50000000000001,4,3,4,11,Bronze
129,12507.0,134,23,1258.06,3,3,2,8,Gold
130,12508.0,26,68,397.88,2,2,3,7,Diamond
131,12509.0,284,7,176.5,4,4,4,12,Bronze
132,12510.0,142,33,982.5699999999999,3,3,2,8,Gold
133,12512.0,66,31,132.18,3,3,4,10,Silver
134,12513.0,84,36,586.7900000000001,3,3,3,9,Gold
135,12514.0,267,51,1017.6800000000001,4,2,2,8,Gold
136,12515.0,353,16,383.70000000000005,4,4,3,11,Bronze
137,12516.0,77,26,1312.06,3,3,2,8,Gold
138,12517.0,28,281,2443.6499999999996,2,1,1,4,Platinum
139,12518.0,0,124,2056.89,1,1,1,3,Platinum
140,12519.0,63,17,330.84000000000003,3,4,3,10,Silver
141,12520.0,79,155,2582.51,3,1,1,5,Platinum
142,12521.0,142,38,599.68,3,3,3,9,Gold
143,12522.0,39,12,192.72000000000003,2,4,4,10,Silver
144,12523.0,1,110,1745.5699999999997,1,1,1,3,Platinum
145,12524.0,9,144,4485.719999999999,1,1,1,3,Platinum
146,12526.0,0,71,1316.6600000000003,1,2,2,5,Platinum
147,12527.0,81,18,348.71000000000004,3,3,3,9,Gold
148,12528.0,9,95,1922.28,1,2,1,4,Platinum
149,12530.0,59,68,1623.6300000000003,3,2,1,6,Diamond
150,12531.0,14,17,125.22,1,4,4,9,Gold
151,12532.0,30,16,349.83000000000004,2,4,3,9,Gold
152,12534.0,130,63,1089.18,3,2,2,7,Diamond
153,12535.0,91,34,716.35,3,3,2,8,Gold
154,12536.0,7,273,4106.82,1,1,1,3,Platinum
155,12538.0,29,21,363.95,2,3,3,8,Gold
156,12539.0,22,274,3852.5,2,1,1,4,Platinum
157,12540.0,19,481,13309.039999999999,2,1,1,4,Platinum
158,12541.0,29,52,981.1800000000002,2,2,2,6,Diamond
159,12544.0,29,20,355.70000000000005,2,3,3,8,Gold
160,12545.0,75,50,1000.39,3,2,2,7,Diamond
161,12546.0,46,70,1141.5,2,2,2,6,Diamond
162,12547.0,197,8,207.8,4,4,4,12,Bronze
163,12548.0,166,5,95.19999999999999,4,4,4,12,Bronze
164,12550.0,79,57,964.83,3,2,2,7,Diamond
165,12551.0,357,10,168.0,4,4,4,12,Bronze
166,12552.0,38,20,437.82,2,3,3,8,Gold
167,12553.0,8,196,3652.25,1,1,1,3,Platinum
168,12556.0,50,119,599.56,2,1,3,6,Diamond
169,12557.0,16,33,11990.96,1,3,1,5,Platinum
170,12558.0,1,22,2.6645352591003757e-14,1,3,4,8,Gold
171,12559.0,310,22,536.2099999999999,4,3,3,10,Silver
172,12560.0,5,111,2101.3900000000003,1,1,1,3,Platinum
173,12561.0,302,16,238.85,4,4,4,12,Bronze
174,12562.0,8,168,3781.74,1,1,1,3,Platinum
175,12564.0,261,21,456.90000000000003,4,3,3,10,Silver
176,12565.0,281,10,131.17000000000002,4,4,4,12,Bronze
177,12566.0,72,20,346.7,3,3,3,9,Gold
178,12567.0,22,463,9114.94,2,1,1,4,Platinum
179,12569.0,2,191,4064.99,1,1,1,3,Platinum
180,12571.0,39,34,519.61,2,3,3,8,Gold
181,12572.0,8,62,1004.7199999999999,1,2,2,5,Platinum
182,12573.0,227,28,160.54,4,3,4,11,Bronze
183,12574.0,315,11,218.45000000000002,4,4,4,12,Bronze
184,12576.0,35,89,1306.98,2,2,2,6,Diamond
185,12577.0,35,147,564.1999999999999,2,1,3,6,Diamond
186,12578.0,21,120,2753.36,2,1,1,4,Platinum
187,12579.0,73,31,410.71999999999997,3,3,3,9,Gold
188,12580.0,246,24,415.70000000000005,4,3,3,10,Silver
189,12581.0,39,15,197.70999999999998,2,4,4,10,Silver
190,12582.0,238,22,511.3599999999999,4,3,3,10,Silver
191,12583.0,2,251,7187.34,1,1,1,3,Platinum
192,12584.0,3,126,1893.9500000000003,1,1,1,3,Platinum
193,12585.0,234,97,1982.81,4,2,1,7,Diamond
194,12586.0,17,12,179.94,2,4,4,10,Silver
195,12587.0,7,4,144.0,1,4,4,9,Gold
196,12588.0,39,10,214.89999999999998,2,4,4,10,Silver
197,12589.0,28,35,646.6800000000001,2,3,2,7,Diamond
198,12590.0,190,70,9861.38,4,2,1,7,Diamond
199,12591.0,317,26,452.84999999999997,4,3,3,10,Silver
200,12592.0,92,18,437.6,3,3,3,9,Gold
201,12593.0,108,21,418.0999999999999,3,3,3,9,Gold
202,12594.0,37,119,3320.2200000000003,2,1,1,4,Platinum
203,12596.0,51,27,618.27,3,3,3,9,Gold
204,12597.0,19,214,3683.13,2,1,1,4,Platinum
205,12598.0,9,133,3002.6800000000003,1,1,1,3,Platinum
206,12599.0,29,62,1032.5800000000004,2,2,2,6,Diamond
207,12600.0,28,65,2581.04,2,2,1,5,Platinum
208,12601.0,189,29,569.5600000000001,4,3,3,10,Silver
209,12602.0,58,12,153.12,3,4,4,11,Bronze
210,12603.0,21,3,739.1999999999999,2,4,2,8,Gold
211,12604.0,79,16,254.17999999999998,3,4,4,11,Bronze
212,12605.0,365,3,-7.5,4,4,4,12,Bronze
213,12607.0,58,202,0.0,3,1,4,8,Gold
214,12609.0,78,60,1126.8500000000001,3,2,2,7,Diamond
215,12610.0,22,111,2057.9900000000002,2,1,1,4,Platinum
216,12611.0,52,65,1193.32,3,2,2,7,Diamond
217,12612.0,57,21,643.59,3,3,3,9,Gold
218,12613.0,31,163,3218.98,2,1,1,4,Platinum
219,12614.0,277,20,315.59999999999997,4,3,3,10,Silver
220,12615.0,2,105,2291.1899999999996,1,1,1,3,Platinum
221,12616.0,85,36,657.2499999999999,3,3,2,8,Gold
222,12617.0,29,41,352.97999999999996,2,3,3,8,Gold
223,12618.0,21,11,177.31,2,4,4,10,Silver
224,12619.0,16,95,3214.8100000000004,1,2,1,4,Platinum
225,12620.0,14,92,1339.41,1,2,2,5,Platinum
226,12621.0,1,474,13612.07,1,1,1,3,Platinum
227,12622.0,232,11,180.09999999999997,4,4,4,12,Bronze
228,12623.0,276,18,305.1,4,3,3,10,Silver
229,12624.0,106,38,641.13,3,3,3,9,Gold
230,12625.0,211,91,2614.32,4,2,1,7,Diamond
231,12626.0,23,307,6388.35,2,1,1,4,Platinum
232,12627.0,10,230,4478.530000000001,1,1,1,3,Platinum
233,12628.0,4,43,769.61,1,2,2,5,Platinum
234,12630.0,9,64,1270.88,1,2,2,5,Platinum
235,12631.0,57,31,640.5,3,3,3,9,Gold
236,12633.0,58,103,2140.63,3,1,1,5,Platinum
237,12635.0,89,101,1689.1800000000003,3,1,1,5,Platinum
238,12637.0,67,386,5934.25,3,1,1,5,Platinum
239,12638.0,33,39,671.69,2,3,2,7,Diamond
240,12639.0,238,22,486.1,4,3,3,10,Silver
241,12640.0,23,53,1174.58,2,2,2,6,Diamond
242,12641.0,115,10,185.9,3,4,4,11,Bronze
243,12642.0,25,47,1013.26,2,2,2,6,Diamond
244,12643.0,128,24,3344.6399999999994,3,3,1,7,Diamond
245,12644.0,129,31,477.90999999999997,3,3,3,9,Gold
246,12645.0,33,74,1755.38,2,2,1,5,Platinum
247,12646.0,4,45,1346.97,1,2,2,5,Platinum
248,12647.0,22,128,3669.92,2,1,1,4,Platinum
249,12648.0,154,21,318.04999999999995,4,3,3,10,Silver
250,12649.0,107,33,603.71,3,3,3,9,Gold
251,12650.0,3,20,314.44,1,3,3,7,Diamond
252,12651.0,334,9,114.0,4,4,4,12,Bronze
253,12652.0,322,51,914.53,4,2,2,8,Gold
254,12653.0,148,43,2209.85,4,2,1,7,Diamond
255,12654.0,10,38,601.9799999999999,1,3,3,7,Diamond
256,12656.0,17,130,3982.7200000000003,2,1,1,4,Platinum
257,12657.0,11,56,1152.06,1,2,2,5,Platinum
258,12658.0,18,36,686.05,2,3,2,7,Diamond
259,12659.0,29,5,91.68,2,4,4,10,Silver
260,12660.0,11,13,245.10000000000002,1,4,4,9,Gold
261,12662.0,0,232,3817.08,1,1,1,3,Platinum
262,12664.0,8,38,4863.88,1,3,1,5,Platinum
263,12665.0,324,4,61.75,4,4,4,12,Bronze
264,12666.0,359,2,-227.44,4,4,4,12,Bronze
265,12667.0,58,33,620.1300000000001,3,3,3,9,Gold
266,12668.0,7,168,3743.1800000000003,1,1,1,3,Platinum
267,12669.0,150,102,1607.73,4,1,2,7,Diamond
268,12670.0,10,94,2986.1499999999996,1,2,1,4,Platinum
269,12672.0,329,10,225.9,4,4,4,12,Bronze
270,12673.0,5,42,610.52,1,2,3,6,Diamond
271,12674.0,11,90,1922.26,1,2,1,4,Platinum
272,12676.0,24,45,1331.39,2,2,2,6,Diamond
273,12678.0,42,167,17588.26,2,1,1,4,Platinum
274,12679.0,52,56,1058.67,3,2,2,7,Diamond
275,12680.0,0,52,862.8100000000002,1,2,2,5,Platinum
276,12681.0,14,646,13677.59,1,1,1,3,Platinum
277,12682.0,3,524,12279.82,1,1,1,3,Platinum
278,12683.0,4,362,8221.09,1,1,1,3,Platinum
279,12684.0,7,105,2283.63,1,1,1,3,Platinum
280,12685.0,28,157,2863.08,2,1,1,4,Platinum
281,12686.0,371,7,89.14,4,4,4,12,Bronze
282,12688.0,113,171,4873.8099999999995,3,1,1,5,Platinum
283,12689.0,25,72,1247.61,2,2,2,6,Diamond
284,12690.0,205,16,389.01,4,4,3,11,Bronze
285,12691.0,28,32,1035.8,2,3,2,7,Diamond
286,12693.0,120,41,830.9599999999999,3,3,2,8,Gold
287,12694.0,70,37,869.67,3,3,2,8,Gold
288,12695.0,7,27,582.1,1,3,3,7,Diamond
289,12697.0,21,43,939.02,2,2,2,6,Diamond
290,12700.0,7,270,4867.99,1,1,1,3,Platinum
291,12701.0,79,53,797.71,3,2,2,7,Diamond
292,12702.0,19,12,219.0,2,4,4,10,Silver
293,12703.0,64,22,274.7,3,3,4,10,Silver
294,12704.0,7,90,2220.8399999999997,1,2,1,4,Platinum
295,12705.0,15,348,6814.24,1,1,1,3,Platinum
296,12707.0,291,33,603.42,4,3,3,10,Silver
297,12708.0,29,174,2616.3199999999997,2,1,1,4,Platinum
298,12709.0,3,256,9264.1,1,1,1,3,Platinum
299,12710.0,96,79,1130.5700000000002,3,2,2,7,Diamond
300,12712.0,22,142,4241.629999999999,2,1,1,4,Platinum
301,12713.0,0,38,848.5500000000001,1,3,2,6,Diamond
302,12714.0,9,259,4708.860000000001,1,1,1,3,Platinum
303,12715.0,106,20,343.35999999999996,3,3,3,9,Gold
304,12716.0,3,69,1053.4900000000002,1,2,2,5,Platinum
305,12717.0,151,56,980.98,4,2,2,8,Gold
306,12718.0,71,19,238.25,3,3,4,10,Silver
307,12719.0,5,42,608.1,1,2,3,6,Diamond
308,12720.0,2,359,5713.28,1,1,1,3,Platinum
309,12721.0,31,164,2628.9799999999996,2,1,1,4,Platinum
310,12722.0,85,57,904.3299999999999,3,2,2,7,Diamond
311,12723.0,3,69,725.07,1,2,2,5,Platinum
312,12724.0,5,53,1031.4099999999999,1,2,2,5,Platinum
313,12725.0,371,24,427.8,4,3,3,10,Silver
314,12726.0,28,124,2609.1,2,1,1,4,Platinum
315,12727.0,10,141,3947.7000000000007,1,1,1,3,Platinum
316,12728.0,71,46,836.3299999999999,3,2,2,7,Diamond
317,12729.0,113,26,453.01000000000005,3,3,3,9,Gold
318,12731.0,23,277,18793.41,2,1,1,4,Platinum
319,12732.0,179,12,236.26000000000005,4,4,4,12,Bronze
320,12733.0,234,22,383.95000000000005,4,3,3,10,Silver
321,12734.0,352,4,110.39999999999999,4,4,4,12,Bronze
322,12735.0,315,43,779.57,4,2,2,8,Gold
323,12736.0,332,4,234.00000000000003,4,4,4,12,Bronze
324,12738.0,372,11,155.35,4,4,4,12,Bronze
325,12739.0,78,38,1013.0400000000001,3,3,2,8,Gold
326,12740.0,63,27,427.59999999999997,3,3,3,9,Gold
327,12743.0,134,131,540.13,3,1,3,7,Diamond
328,12744.0,51,229,9120.39,3,1,1,5,Platinum
329,12747.0,2,103,4196.009999999999,1,1,1,3,Platinum
330,12748.0,0,4459,28405.560000000005,1,1,1,3,Platinum
331,12749.0,3,231,3868.2000000000007,1,1,1,3,Platinum
332,12750.0,128,15,275.88,3,4,4,11,Bronze
333,12752.0,81,53,4366.780000000001,3,2,1,6,Diamond
334,12753.0,3,230,21024.01,1,1,1,3,Platinum
335,12754.0,235,65,2949.12,4,2,1,7,Diamond
336,12755.0,249,6,2203.1999999999994,4,4,1,9,Gold
337,12756.0,86,4,112.08000000000001,3,4,4,11,Bronze
338,12757.0,15,370,4205.25,1,1,1,3,Platinum
339,12758.0,116,97,2791.59,3,2,1,6,Diamond
340,12759.0,52,95,1531.4400000000003,3,2,2,7,Diamond
341,12762.0,7,69,1898.5200000000004,1,2,1,4,Platinum
342,12763.0,138,18,494.08000000000004,3,3,3,9,Gold
343,12764.0,316,45,1693.88,4,2,1,7,Diamond
344,12766.0,3,310,6989.63,1,1,1,3,Platinum
345,12769.0,238,32,1143.6,4,3,2,9,Gold
346,12770.0,210,12,1351.4499999999998,4,4,2,10,Silver
347,12772.0,59,55,892.4700000000001,3,2,2,7,Diamond
348,12775.0,17,67,1351.2400000000002,2,2,2,6,Diamond
349,12778.0,19,51,804.23,2,2,2,6,Diamond
350,12779.0,21,159,3868.7,2,1,1,4,Platinum
351,12781.0,21,30,707.7200000000001,2,3,2,7,Diamond
352,12782.0,4,107,2273.32,1,1,1,3,Platinum
353,12783.0,2,86,1603.87,1,2,2,5,Platinum
354,12784.0,9,57,532.8199999999999,1,2,3,6,Diamond
355,12785.0,2,15,305.71,1,4,3,8,Gold
356,12787.0,9,20,463.65999999999997,1,3,3,7,Diamond
357,12789.0,65,4,91.85000000000001,3,4,4,11,Bronze
358,12790.0,192,21,324.9200000000001,4,3,3,10,Silver
359,12791.0,373,2,192.60000000000002,4,4,4,12,Bronze
360,12792.0,256,25,400.53999999999996,4,3,3,10,Silver
361,12793.0,334,24,545.48,4,3,3,10,Silver
362,12794.0,53,45,860.41,3,2,2,7,Diamond
363,12795.0,18,14,430.48,2,4,3,9,Gold
364,12797.0,360,17,194.18,4,4,4,12,Bronze
365,12798.0,10,8,6977.04,1,4,1,6,Diamond
366,12802.0,183,26,412.58,4,3,3,10,Silver
367,12808.0,36,28,483.65000000000003,2,3,3,8,Gold
368,12809.0,168,26,484.36,4,3,3,10,Silver
369,12811.0,260,31,514.8499999999999,4,3,3,10,Silver
370,12812.0,44,15,229.64,2,4,4,10,Silver
371,12814.0,101,2,125.92,3,4,4,11,Bronze
372,12815.0,147,47,1063.46,4,2,2,8,Gold
373,12816.0,95,29,572.2,3,3,3,9,Gold
374,12817.0,281,4,166.04,4,4,4,12,Bronze
375,12818.0,178,16,1517.88,4,4,2,10,Silver
376,12820.0,3,59,942.34,1,2,2,5,Platinum
377,12821.0,214,6,92.72,4,4,4,12,Bronze
378,12822.0,70,47,918.9800000000001,3,2,2,7,Diamond
379,12823.0,74,5,1759.5,3,4,1,8,Gold
380,12824.0,59,25,397.11999999999995,3,3,3,9,Gold
381,12826.0,2,94,1468.1200000000001,1,2,2,5,Platinum
382,12827.0,5,25,430.15,1,3,3,7,Diamond
383,12828.0,2,56,1018.71,1,2,2,5,Platinum
384,12829.0,322,12,253.05,4,4,4,12,Bronze
385,12830.0,37,39,6748.400000000001,2,3,1,6,Diamond
386,12831.0,262,9,215.05,4,4,4,12,Bronze
387,12832.0,32,27,383.03000000000003,2,3,3,8,Gold
388,12833.0,145,24,417.38,4,3,3,10,Silver
389,12834.0,282,18,312.38,4,3,3,10,Silver
390,12836.0,59,174,2610.3599999999997,3,1,1,5,Platinum
391,12837.0,173,12,134.1,4,4,4,12,Bronze
392,12838.0,33,120,671.95,2,1,2,5,Platinum
393,12839.0,2,316,5583.62,1,1,1,3,Platinum
394,12840.0,143,116,2714.2700000000004,3,1,1,5,Platinum
395,12841.0,4,433,3845.63,1,1,1,3,Platinum
396,12842.0,70,34,1118.99,3,3,2,8,Gold
397,12843.0,65,108,1680.7600000000002,3,1,1,5,Platinum
398,12844.0,29,52,325.96,2,2,3,7,Diamond
399,12845.0,267,27,354.09,4,3,3,10,Silver
400,12847.0,22,84,843.6399999999999,2,2,2,6,Diamond
401,12849.0,31,48,1010.2900000000001,2,2,2,6,Diamond
402,12851.0,96,47,131.80999999999997,3,2,4,9,Gold
403,12852.0,290,20,299.75000000000006,4,3,3,10,Silver
404,12853.0,107,84,1881.7,3,2,1,6,Diamond
405,12854.0,78,114,1280.9,3,1,2,6,Diamond
406,12855.0,372,3,38.1,4,4,4,12,Bronze
407,12856.0,7,314,2153.5299999999997,1,1,1,3,Platinum
408,12857.0,210,46,1106.4,4,2,2,8,Gold
409,12863.0,52,6,504.20000000000005,3,4,3,10,Silver
410,12864.0,138,3,147.12,3,4,4,11,Bronze
411,12865.0,26,96,1548.07,2,2,2,6,Diamond
412,12866.0,283,26,559.12,4,3,3,10,Silver
413,12867.0,26,547,3958.74,2,1,1,4,Platinum
414,12868.0,185,107,1607.0600000000002,4,1,2,7,Diamond
415,12870.0,366,2,-14.899999999999999,4,4,4,12,Bronze
416,12871.0,84,11,380.64000000000004,3,4,3,10,Silver
417,12872.0,326,66,599.9700000000001,4,2,3,9,Gold
418,12873.0,282,4,374.0,4,4,3,11,Bronze
419,12875.0,143,2,343.2300000000001,3,4,3,10,Silver
420,12876.0,57,85,2218.020000000001,3,2,1,6,Diamond
421,12877.0,3,154,1535.7700000000002,1,1,2,4,Platinum
422,12878.0,18,49,841.64,2,2,2,6,Diamond
423,12879.0,44,12,552.57,2,4,3,9,Gold
424,12881.0,275,7,298.0,4,4,3,11,Bronze
425,12882.0,9,13,1463.0399999999997,1,4,2,7,Diamond
426,12883.0,24,42,703.47,2,2,2,6,Diamond
427,12884.0,88,7,309.05000000000007,3,4,3,10,Silver
428,12885.0,63,72,1158.27,3,2,2,7,Diamond
429,12886.0,67,86,1351.09,3,2,2,7,Diamond
430,12888.0,214,7,313.77,4,4,3,11,Bronze
431,12890.0,24,79,376.71999999999997,2,2,3,7,Diamond
432,12891.0,185,3,331.0,4,4,3,11,Bronze
433,12893.0,30,31,176.54999999999998,2,3,4,9,Gold
434,12895.0,42,24,347.3,2,3,3,8,Gold
435,12897.0,204,4,216.5,4,4,4,12,Bronze
436,12901.0,8,125,16293.1,1,1,1,3,Platinum
437,12902.0,264,10,138.67999999999998,4,4,4,12,Bronze
438,12904.0,18,71,496.06,2,2,3,7,Diamond
439,12906.0,11,63,2919.81,1,2,1,4,Platinum
440,12908.0,58,4,246.0,3,4,4,11,Bronze
441,12909.0,39,96,2128.83,2,2,1,5,Platinum
442,12910.0,23,75,3075.0400000000004,2,2,1,5,Platinum
443,12912.0,2,24,1662.3,1,3,1,5,Platinum
444,12913.0,4,50,2483.6299999999997,1,2,1,4,Platinum
445,12915.0,148,22,363.65,4,3,3,10,Silver
446,12916.0,138,105,2921.1499999999996,3,1,1,5,Platinum
447,12917.0,128,2,594.0,3,4,3,10,Silver
448,12919.0,8,52,1301.44,1,2,2,5,Platinum
449,12920.0,17,27,162.77999999999997,2,3,4,9,Gold
450,12921.0,3,741,16389.74,1,1,1,3,Platinum
451,12922.0,161,28,405.38,4,3,3,10,Silver
452,12923.0,64,28,172.81999999999996,3,3,4,10,Silver
453,12924.0,88,31,929.9500000000002,3,3,2,8,Gold
454,12925.0,4,45,694.05,1,2,2,5,Platinum
455,12928.0,35,84,2062.7,2,2,1,5,Platinum
456,12929.0,122,9,105.1,3,4,4,11,Bronze
457,12930.0,78,27,409.9,3,3,3,9,Gold
458,12931.0,21,102,33462.81,2,1,1,4,Platinum
459,12933.0,24,107,606.28,2,1,3,6,Diamond
460,12935.0,2,130,2156.45,1,1,1,3,Platinum
461,12936.0,17,63,1012.9000000000001,2,2,2,6,Diamond
462,12937.0,15,120,1504.2700000000002,1,1,2,4,Platinum
463,12938.0,25,9,114.13999999999999,2,4,4,10,Silver
464,12939.0,64,47,11581.800000000001,3,2,1,6,Diamond
465,12940.0,46,100,862.4399999999999,2,1,2,5,Platinum
466,12942.0,131,70,675.6,3,2,2,7,Diamond
467,12943.0,301,1,-3.75,4,4,4,12,Bronze
468,12944.0,35,30,604.5099999999999,2,3,3,8,Gold
469,12945.0,288,23,462.95000000000005,4,3,3,10,Silver
470,12947.0,143,103,1407.2900000000002,3,1,2,6,Diamond
471,12948.0,16,118,2053.7,1,1,1,3,Platinum
472,12949.0,30,219,4143.0199999999995,2,1,1,4,Platinum
473,12950.0,2,23,1843.0,1,3,1,5,Platinum
474,12951.0,8,65,1042.07,1,2,2,5,Platinum
475,12952.0,5,80,1382.8400000000001,1,2,2,5,Platinum
476,12953.0,9,17,329.85,1,4,3,8,Gold
477,12955.0,1,183,4734.26,1,1,1,3,Platinum
478,12956.0,306,19,108.07,4,3,4,11,Bronze
479,12957.0,4,244,3979.04,1,1,1,3,Platinum
480,12962.0,7,16,266.39,1,4,4,9,Gold
481,12963.0,8,96,1841.0300000000002,1,2,1,4,Platinum
482,12965.0,89,108,769.8100000000001,3,1,2,6,Diamond
483,12966.0,9,10,160.18,1,4,4,9,Gold
484,12967.0,3,33,1194.75,1,3,2,6,Diamond
485,12968.0,112,5,135.95,3,4,4,11,Bronze
486,12970.0,7,129,405.47,1,1,3,5,Platinum
487,12971.0,3,308,10930.259999999998,1,1,1,3,Platinum
488,12974.0,197,8,144.8,4,4,4,12,Bronze
489,12976.0,211,22,738.6,4,3,2,9,Gold
490,12977.0,156,9,39.24,4,4,4,12,Bronze
491,12980.0,155,24,7092.060000000001,4,3,1,8,Gold
492,12981.0,29,20,372.2199999999999,2,3,3,8,Gold
493,12982.0,239,34,377.20000000000005,4,3,3,10,Silver
494,12984.0,18,4,97.5,2,4,4,10,Silver
495,12985.0,0,78,1215.6200000000001,1,2,2,5,Platinum
496,12987.0,73,30,545.0,3,3,3,9,Gold
497,12988.0,292,83,505.82000000000005,4,2,3,9,Gold
498,12989.0,3,68,6854.51,1,2,1,4,Platinum
499,12990.0,31,13,409.5000000000001,2,4,3,9,Gold
500,12991.0,23,31,503.76000000000005,2,3,3,8,Gold
501,12993.0,23,27,414.75999999999993,2,3,3,8,Gold
502,12994.0,4,73,902.2199999999999,1,2,2,5,Platinum
503,12995.0,77,5,200.72,3,4,4,11,Bronze
504,12997.0,22,67,1197.94,2,2,2,6,Diamond
505,12999.0,196,28,455.88,4,3,3,10,Silver
506,13000.0,106,31,534.8500000000001,3,3,3,9,Gold
507,13001.0,4,340,9765.07,1,1,1,3,Platinum
508,13002.0,318,7,120.94999999999999,4,4,4,12,Bronze
509,13003.0,105,6,149.05,3,4,4,11,Bronze
510,13004.0,11,409,5613.43,1,1,1,3,Platinum
511,13005.0,173,29,468.95000000000005,4,3,3,10,Silver
512,13006.0,56,4,81.57,3,4,4,11,Bronze
513,13008.0,323,15,178.47,4,4,4,12,Bronze
514,13011.0,372,3,50.550000000000004,4,4,4,12,Bronze
515,13012.0,9,106,1296.6200000000001,1,1,2,4,Platinum
516,13013.0,1,222,4786.99,1,1,1,3,Platinum
517,13014.0,2,124,3365.4300000000003,1,1,1,3,Platinum
518,13015.0,53,175,3339.6400000000003,3,1,1,5,Platinum
519,13016.0,73,47,789.8899999999999,3,2,2,7,Diamond
520,13017.0,7,1,204.0,1,4,4,9,Gold
521,13018.0,16,459,7272.75,1,1,1,3,Platinum
522,13021.0,4,134,2584.4,1,1,1,3,Platinum
523,13023.0,64,40,689.9000000000001,3,3,2,8,Gold
524,13026.0,1,43,936.1500000000001,1,2,2,5,Platinum
525,13027.0,113,26,6912.0,3,3,1,7,Diamond
526,13028.0,22,47,659.6800000000001,2,2,2,6,Diamond
527,13029.0,30,10,1247.5,2,4,2,8,Gold
528,13030.0,11,92,752.4399999999999,1,2,2,5,Platinum
529,13032.0,38,75,996.5200000000002,2,2,2,6,Diamond
530,13033.0,357,11,190.54999999999998,4,4,4,12,Bronze
531,13034.0,54,37,642.7700000000001,3,3,3,9,Gold
532,13035.0,57,30,886.6299999999999,3,3,2,8,Gold
533,13037.0,138,48,881.07,3,2,2,7,Diamond
534,13038.0,80,28,908.46,3,3,2,8,Gold
535,13040.0,8,43,676.99,1,2,2,5,Platinum
536,13043.0,253,14,471.57000000000005,4,4,3,11,Bronze
537,13044.0,291,33,560.47,4,3,3,10,Silver
538,13045.0,99,18,305.28,3,3,3,9,Gold
539,13046.0,30,35,629.31,2,3,3,8,Gold
540,13047.0,31,196,3079.1,2,1,1,4,Platinum
541,13048.0,14,136,1789.4099999999999,1,1,1,3,Platinum
542,13049.0,64,14,656.6800000000002,3,4,2,9,Gold
543,13050.0,9,422,5684.61,1,1,1,3,Platinum
544,13052.0,212,18,348.15000000000003,4,3,3,10,Silver
545,13055.0,64,78,1201.96,3,2,2,7,Diamond
546,13058.0,24,8,271.4,2,4,4,10,Silver
547,13059.0,249,8,183.4,4,4,4,12,Bronze
548,13060.0,253,15,307.53000000000003,4,4,3,11,Bronze
549,13061.0,72,10,248.61,3,4,4,11,Bronze
550,13062.0,191,11,346.98,4,4,3,11,Bronze
551,13064.0,12,68,1105.5900000000001,1,2,2,5,Platinum
552,13065.0,373,14,205.85999999999999,4,4,4,12,Bronze
553,13066.0,24,49,430.9,2,2,3,7,Diamond
554,13067.0,82,15,115.46000000000001,3,4,4,11,Bronze
555,13068.0,10,2,344.0,1,4,3,8,Gold
556,13069.0,0,469,3713.14,1,1,1,3,Platinum
557,13070.0,192,9,228.8,4,4,4,12,Bronze
558,13072.0,266,7,177.14999999999998,4,4,4,12,Bronze
559,13075.0,129,22,919.6100000000001,3,3,2,8,Gold
560,13077.0,1,111,728.0200000000001,1,1,2,4,Platinum
561,13078.0,1,380,12432.28,1,1,1,3,Platinum
562,13079.0,4,6,220.09999999999997,1,4,4,9,Gold
563,13080.0,179,6,58.08,4,4,4,12,Bronze
564,13081.0,1,1061,27964.48,1,1,1,3,Platinum
565,13082.0,126,75,3595.48,3,2,1,6,Diamond
566,13083.0,4,18,303.75,1,3,3,7,Diamond
567,13085.0,157,29,272.38,4,3,4,11,Bronze
568,13089.0,2,1853,57322.130000000005,1,1,1,3,Platinum
569,13090.0,8,161,8689.39,1,1,1,3,Platinum
570,13091.0,21,24,319.82,2,3,3,8,Gold
571,13092.0,70,26,459.83000000000004,3,3,3,9,Gold
572,13093.0,267,170,7741.47,4,1,1,6,Diamond
573,13094.0,21,30,1708.8600000000001,2,3,1,6,Diamond
574,13095.0,70,6,74.4,3,4,4,11,Bronze
575,13097.0,32,435,5886.12,2,1,1,4,Platinum
576,13098.0,1,605,28658.879999999997,1,1,1,3,Platinum
577,13099.0,99,1,207.35999999999999,3,4,4,11,Bronze
578,13101.0,234,8,101.19,4,4,4,12,Bronze
579,13102.0,1,310,6336.29,1,1,1,3,Platinum
580,13103.0,39,8,243.94,2,4,4,10,Silver
581,13104.0,3,20,1098.48,1,3,2,6,Diamond
582,13106.0,128,2,59.5,3,4,4,11,Bronze
583,13107.0,44,60,1524.0700000000004,2,2,2,6,Diamond
584,13108.0,372,10,350.05999999999995,4,4,3,11,Bronze
585,13109.0,2,50,766.84,1,2,2,5,Platinum
586,13110.0,31,146,1452.8700000000001,2,1,2,5,Platinum
587,13113.0,0,280,10510.0,1,1,1,3,Platinum
588,13115.0,8,132,2205.63,1,1,1,3,Platinum
589,13116.0,117,31,485.19,3,3,3,9,Gold
590,13117.0,21,76,984.9100000000001,2,2,2,6,Diamond
591,13118.0,19,82,1125.0,2,2,2,6,Diamond
592,13120.0,238,1,30.599999999999998,4,4,4,12,Bronze
593,13121.0,269,53,254.72999999999996,4,2,4,10,Silver
594,13122.0,94,55,922.39,3,2,2,7,Diamond
595,13124.0,89,222,3756.33,3,1,1,5,Platinum
596,13126.0,4,142,2056.29,1,1,1,3,Platinum
597,13127.0,77,15,259.16999999999996,3,4,4,11,Bronze
598,13130.0,94,2,64.0,3,4,4,11,Bronze
599,13131.0,23,46,1039.3000000000002,2,2,2,6,Diamond
600,13132.0,261,3,77.3,4,4,4,12,Bronze
601,13133.0,273,7,109.80000000000001,4,4,4,12,Bronze
602,13134.0,72,105,1740.63,3,1,1,5,Platinum
603,13135.0,196,1,3096.0,4,4,1,9,Gold
604,13136.0,50,139,2545.38,2,1,1,4,Platinum
605,13137.0,10,688,3557.96,1,1,1,3,Platinum
606,13138.0,22,63,962.39,2,2,2,6,Diamond
607,13139.0,16,174,5055.790000000001,1,1,1,3,Platinum
608,13140.0,108,45,422.47,3,2,3,8,Gold
609,13141.0,84,136,2385.8,3,1,1,5,Platinum
610,13142.0,19,23,307.0899999999999,2,3,3,8,Gold
611,13144.0,332,3,110.94999999999999,4,4,4,12,Bronze
612,13145.0,39,7,614.77,2,4,3,9,Gold
613,13146.0,26,17,228.91,2,4,4,10,Silver
614,13147.0,10,4,712.8000000000001,1,4,2,7,Diamond
615,13148.0,29,340,3324.62,2,1,1,4,Platinum
616,13149.0,14,86,1676.0600000000002,1,2,1,4,Platinum
617,13151.0,203,75,1250.3700000000003,4,2,2,8,Gold
618,13153.0,5,15,486.22,1,4,3,8,Gold
619,13154.0,144,1,-611.86,4,4,4,12,Bronze
620,13155.0,33,85,971.7600000000002,2,2,2,6,Diamond
621,13157.0,49,89,1721.57,2,2,1,5,Platinum
622,13158.0,94,79,1201.06,3,2,2,7,Diamond
623,13159.0,8,121,1371.25,1,1,2,4,Platinum
624,13160.0,22,4,91.8,2,4,4,10,Silver
625,13161.0,313,8,112.75,4,4,4,12,Bronze
626,13162.0,122,82,1644.9899999999998,3,2,1,6,Diamond
627,13165.0,46,42,1021.48,2,2,2,6,Diamond
628,13166.0,282,42,414.70000000000005,4,2,3,9,Gold
629,13167.0,18,65,791.3299999999999,2,2,2,6,Diamond
630,13168.0,36,128,1290.5400000000002,2,1,2,5,Platinum
631,13169.0,63,13,712.88,3,4,2,9,Gold
632,13170.0,26,30,108.81,2,3,4,9,Gold
633,13171.0,8,48,426.80999999999995,1,2,3,6,Diamond
634,13173.0,4,43,353.65000000000003,1,2,3,6,Diamond
635,13174.0,16,293,2742.8200000000006,1,1,1,3,Platinum
636,13176.0,46,67,481.49000000000007,2,2,3,7,Diamond
637,13177.0,64,17,282.45,3,4,4,11,Bronze
638,13178.0,26,265,5725.469999999999,2,1,1,4,Platinum
639,13182.0,45,11,121.18,2,4,4,10,Silver
640,13183.0,7,94,3957.7800000000007,1,2,1,4,Platinum
641,13184.0,14,181,1616.4499999999998,1,1,1,3,Platinum
642,13185.0,267,1,71.4,4,4,4,12,Bronze
643,13186.0,39,84,1539.69,2,2,2,6,Diamond
644,13187.0,337,37,236.01999999999998,4,3,4,11,Bronze
645,13188.0,11,2,114.60000000000001,1,4,4,9,Gold
646,13189.0,18,29,260.67999999999995,2,3,4,9,Gold
647,13192.0,95,63,911.9400000000002,3,2,2,7,Diamond
648,13193.0,61,25,112.08,3,3,4,10,Silver
649,13194.0,135,3,60.7,3,4,4,11,Bronze
650,13196.0,11,110,1797.78,1,1,1,3,Platinum
651,13198.0,10,229,3384.09,1,1,1,3,Platinum
652,13199.0,3,120,9803.96,1,1,1,3,Platinum
653,13200.0,19,46,870.0900000000001,2,2,2,6,Diamond
654,13203.0,9,57,869.4599999999999,1,2,2,5,Platinum
655,13207.0,15,8,250.26000000000002,1,4,4,9,Gold
656,13208.0,58,149,1199.6499999999999,3,1,2,6,Diamond
657,13209.0,30,329,5820.16,2,1,1,4,Platinum
658,13210.0,93,22,353.48,3,3,3,9,Gold
659,13211.0,10,55,1095.4199999999996,1,2,2,5,Platinum
660,13212.0,9,142,779.33,1,1,2,4,Platinum
661,13213.0,56,92,1518.43,3,2,2,7,Diamond
662,13216.0,267,5,333.74,4,4,3,11,Bronze
663,13217.0,122,7,133.62000000000003,3,4,4,11,Bronze
664,13218.0,127,5,62.64,3,4,4,11,Bronze
665,13220.0,78,21,819.29,3,3,2,8,Gold
666,13221.0,240,66,847.4100000000001,4,2,2,8,Gold
667,13223.0,200,5,163.20000000000002,4,4,4,12,Bronze
668,13224.0,60,109,2150.8499999999995,3,1,1,5,Platinum
669,13225.0,3,34,6083.04,1,3,1,5,Platinum
670,13226.0,273,16,108.21,4,4,4,12,Bronze
671,13227.0,201,9,257.7,4,4,4,12,Bronze
672,13228.0,81,2,358.0,3,4,3,10,Silver
673,13229.0,225,10,160.95,4,4,4,12,Bronze
674,13230.0,4,588,2712.0699999999997,1,1,1,3,Platinum
675,13232.0,12,202,1328.35,1,1,2,4,Platinum
676,13233.0,74,43,605.1199999999999,3,2,3,8,Gold
677,13235.0,211,59,101.17000000000019,4,2,4,10,Silver
678,13236.0,24,39,727.2700000000001,2,3,2,7,Diamond
679,13238.0,11,32,680.8299999999999,1,3,2,6,Diamond
680,13239.0,261,22,329.56,4,3,3,10,Silver
681,13240.0,96,67,663.6500000000001,3,2,2,7,Diamond
682,13242.0,112,13,270.40000000000003,3,4,4,11,Bronze
683,13243.0,203,57,585.12,4,2,3,9,Gold
684,13244.0,92,27,121.74,3,3,4,10,Silver
685,13245.0,50,16,430.5,2,4,3,9,Gold
686,13246.0,18,138,1896.3200000000002,2,1,1,4,Platinum
687,13247.0,17,25,501.11999999999995,2,3,3,8,Gold
688,13248.0,124,26,465.67999999999995,3,3,3,9,Gold
689,13249.0,92,23,711.41,3,3,2,8,Gold
690,13253.0,156,36,1030.3999999999999,4,3,2,9,Gold
691,13255.0,3,14,390.65999999999997,1,4,3,8,Gold
692,13256.0,14,1,0.0,1,4,4,9,Gold
693,13258.0,11,36,672.83,1,3,2,6,Diamond
694,13259.0,61,81,283.18,3,2,4,9,Gold
695,13260.0,61,8,557.62,3,4,3,10,Silver
696,13261.0,268,9,944.1,4,4,2,10,Silver
697,13262.0,263,11,200.29,4,4,4,12,Bronze
698,13263.0,1,1667,7436.93,1,1,1,3,Platinum
699,13265.0,53,90,2092.6600000000003,3,2,1,6,Diamond
700,13266.0,11,202,3717.67,1,1,1,3,Platinum
701,13267.0,2,224,4404.4400000000005,1,1,1,3,Platinum
702,13268.0,17,440,3127.7000000000003,2,1,1,4,Platinum
703,13269.0,1,319,5312.970000000001,1,1,1,3,Platinum
704,13270.0,366,1,590.0,4,4,3,11,Bronze
705,13271.0,37,92,172.36999999999998,2,2,4,8,Gold
706,13272.0,31,15,276.56000000000006,2,4,4,10,Silver
707,13273.0,113,16,138.98,3,4,4,11,Bronze
708,13276.0,63,30,590.93,3,3,3,9,Gold
709,13277.0,15,8,258.4,1,4,4,9,Gold
710,13278.0,40,46,542.73,2,2,3,7,Diamond
711,13279.0,64,11,126.3,3,4,4,11,Bronze
712,13280.0,122,82,798.46,3,2,2,7,Diamond
713,13282.0,18,40,1047.8400000000001,2,3,2,7,Diamond
714,13283.0,59,7,93.66,3,4,4,11,Bronze
715,13284.0,322,14,196.15,4,4,4,12,Bronze
716,13285.0,23,187,2709.1200000000003,2,1,1,4,Platinum
717,13291.0,155,42,361.11,4,2,3,9,Gold
718,13292.0,38,31,578.9399999999999,2,3,3,8,Gold
719,13294.0,189,54,873.74,4,2,2,8,Gold
720,13295.0,359,11,197.95,4,4,4,12,Bronze
721,13296.0,137,5,87.4,3,4,4,11,Bronze
722,13297.0,7,59,2089.85,1,2,1,4,Platinum
723,13298.0,1,2,360.0,1,4,3,8,Gold
724,13299.0,268,5,142.5,4,4,4,12,Bronze
725,13300.0,164,22,365.29,4,3,3,10,Silver
726,13301.0,103,81,618.09,3,2,3,8,Gold
727,13302.0,155,1,63.75,4,4,4,12,Bronze
728,13304.0,351,21,300.41999999999996,4,3,3,10,Silver
729,13305.0,4,81,2000.8599999999997,1,2,1,4,Platinum
730,13307.0,120,1,15.0,3,4,4,11,Bronze
731,13308.0,22,57,1367.6100000000001,2,2,2,6,Diamond
732,13309.0,7,107,1456.79,1,1,2,4,Platinum
733,13310.0,8,77,1083.63,1,2,2,5,Platinum
734,13311.0,4,26,598.57,1,3,3,7,Diamond
735,13313.0,22,78,1555.32,2,2,2,6,Diamond
736,13314.0,1,74,593.51,1,2,3,6,Diamond
737,13316.0,37,87,5570.6900000000005,2,2,1,5,Platinum
738,13317.0,64,135,2140.07,3,1,1,5,Platinum
739,13318.0,1,20,640.7600000000001,1,3,3,7,Diamond
740,13319.0,5,500,10664.34,1,1,1,3,Platinum
741,13320.0,70,109,1475.2,3,1,2,6,Diamond
742,13321.0,72,11,567.36,3,4,3,10,Silver
743,13322.0,17,25,199.48,2,3,4,9,Gold
744,13323.0,3,21,787.8499999999999,1,3,2,6,Diamond
745,13324.0,32,77,7072.799999999998,2,2,1,5,Platinum
746,13325.0,81,12,675.3,3,4,2,9,Gold
747,13327.0,38,109,3617.5699999999993,2,1,1,4,Platinum
748,13328.0,316,17,1308.48,4,4,2,10,Silver
749,13329.0,31,19,740.3999999999999,2,3,2,7,Diamond
750,13330.0,92,53,1140.93,3,2,2,7,Diamond
751,13332.0,14,21,350.9,1,3,3,7,Diamond
752,13334.0,82,265,3502.32,3,1,1,5,Platinum
753,13336.0,77,51,795.1200000000001,3,2,2,7,Diamond
754,13338.0,154,24,431.82000000000005,4,3,3,10,Silver
755,13339.0,200,54,860.12,4,2,2,8,Gold
756,13340.0,45,134,10736.48,2,1,1,4,Platinum
757,13341.0,260,42,775.8499999999999,4,2,2,8,Gold
758,13343.0,172,22,303.93,4,3,3,10,Silver
759,13344.0,67,116,2511.6900000000005,3,1,1,5,Platinum
760,13345.0,276,22,377.6,4,3,3,10,Silver
761,13347.0,70,8,341.36,3,4,3,10,Silver
762,13348.0,64,14,233.76,3,4,4,11,Bronze
763,13349.0,10,16,247.32,1,4,4,9,Gold
764,13350.0,16,43,910.72,1,2,2,5,Platinum
765,13351.0,66,16,373.94,3,4,3,10,Silver
766,13352.0,7,27,389.28,1,3,3,7,Diamond
767,13354.0,71,51,743.5300000000001,3,2,2,7,Diamond
768,13355.0,122,32,674.7,3,3,2,8,Gold
769,13356.0,80,42,768.2400000000001,3,2,2,7,Diamond
770,13357.0,257,89,609.4000000000001,4,2,3,9,Gold
771,13358.0,268,29,439.03000000000003,4,3,3,10,Silver
772,13359.0,59,24,431.26,3,3,3,9,Gold
773,13362.0,3,169,3085.49,1,1,1,3,Platinum
774,13363.0,17,60,992.5,2,2,2,6,Diamond
775,13364.0,66,20,7.105427357601002e-15,3,3,4,10,Silver
776,13365.0,8,132,2191.2200000000003,1,1,1,3,Platinum
777,13366.0,50,1,56.160000000000004,2,4,4,10,Silver
778,13368.0,256,29,623.4,4,3,3,10,Silver
779,13369.0,354,19,263.75,4,3,4,11,Bronze
780,13370.0,366,44,721.3199999999999,4,2,2,8,Gold
781,13372.0,89,23,378.63999999999993,3,3,3,9,Gold
782,13373.0,60,158,3312.2500000000005,3,1,1,5,Platinum
783,13375.0,81,38,772.9,3,3,2,8,Gold
784,13376.0,99,53,1019.76,3,2,2,7,Diamond
785,13379.0,26,97,572.56,2,2,3,7,Diamond
786,13381.0,21,173,3626.81,2,1,1,4,Platinum
787,13382.0,280,15,222.99,4,4,4,12,Bronze
788,13384.0,30,155,4122.28,2,1,1,4,Platinum
789,13385.0,329,35,534.5699999999999,4,3,3,10,Silver
790,13388.0,121,36,627.15,3,3,3,9,Gold
791,13389.0,11,51,797.9599999999999,1,2,2,5,Platinum
792,13390.0,74,13,544.08,3,4,3,10,Silver
793,13391.0,203,1,59.8,4,4,4,12,Bronze
794,13394.0,1,164,2312.8,1,1,1,3,Platinum
795,13395.0,185,21,307.71999999999997,4,3,3,10,Silver
796,13396.0,21,47,1325.29,2,2,2,6,Diamond
797,13397.0,72,39,1539.1799999999998,3,3,2,8,Gold
798,13398.0,192,26,457.34000000000003,4,3,3,10,Silver
799,13402.0,127,39,621.2300000000002,3,3,3,9,Gold
800,13403.0,17,3,75.0,2,4,4,10,Silver
801,13404.0,1,11,252.49,1,4,4,9,Gold
802,13405.0,74,27,572.4509999999999,3,3,3,9,Gold
803,13408.0,1,501,27487.41,1,1,1,3,Platinum
804,13410.0,8,30,988.9100000000001,1,3,2,6,Diamond
805,13411.0,107,18,213.55,3,3,4,10,Silver
806,13414.0,133,24,1390.5,3,3,2,8,Gold
807,13416.0,43,19,712.5,2,3,2,7,Diamond
808,13417.0,4,28,640.83,1,3,3,7,Diamond
809,13418.0,11,314,5845.4400000000005,1,1,1,3,Platinum
810,13419.0,63,16,221.06,3,4,4,11,Bronze
811,13420.0,134,10,140.35,3,4,4,11,Bronze
812,13421.0,40,103,1831.61,2,1,1,4,Platinum
813,13422.0,51,128,2601.55,3,1,1,5,Platinum
814,13425.0,108,78,1624.2100000000003,3,2,1,6,Diamond
815,13426.0,0,159,3550.7,1,1,1,3,Platinum
816,13427.0,19,29,582.6,2,3,3,8,Gold
817,13428.0,10,71,201.78,1,2,4,7,Diamond
818,13429.0,10,67,1006.7999999999998,1,2,2,5,Platinum
819,13430.0,18,54,648.6899999999999,2,2,2,6,Diamond
820,13431.0,67,46,1269.1,3,2,2,7,Diamond
821,13434.0,74,10,534.24,3,4,3,10,Silver
822,13435.0,5,103,3794.4900000000002,1,1,1,3,Platinum
823,13436.0,1,12,196.88999999999996,1,4,4,9,Gold
824,13437.0,14,167,3408.0600000000004,1,1,1,3,Platinum
825,13439.0,255,54,283.71,4,2,4,10,Silver
826,13441.0,91,13,296.64000000000004,3,4,3,10,Silver
827,13447.0,23,62,1104.2300000000002,2,2,2,6,Diamond
828,13448.0,16,198,3460.9900000000007,1,1,1,3,Platinum
829,13449.0,23,19,291.88000000000005,2,3,3,8,Gold
830,13450.0,26,71,2043.72,2,2,1,5,Platinum
831,13451.0,26,434,2838.56,2,1,1,4,Platinum
832,13452.0,259,2,590.0,4,4,3,11,Bronze
833,13453.0,165,17,356.97999999999996,4,4,3,11,Bronze
834,13455.0,24,53,1007.3499999999999,2,2,2,6,Diamond
835,13456.0,17,65,1737.82,2,2,1,5,Platinum
836,13458.0,7,394,9537.92,1,1,1,3,Platinum
837,13460.0,29,17,183.44,2,4,4,10,Silver
838,13461.0,38,27,1445.0000000000002,2,3,2,7,Diamond
839,13462.0,183,10,143.25,4,4,4,12,Bronze
840,13464.0,58,41,674.6800000000001,3,3,2,8,Gold
841,13466.0,100,18,297.95000000000005,3,3,3,9,Gold
842,13467.0,10,98,1071.91,1,2,2,5,Platinum
843,13468.0,1,306,5656.75,1,1,1,3,Platinum
844,13470.0,99,10,165.0,3,4,4,11,Bronze
845,13471.0,1,254,2501.84,1,1,1,3,Platinum
846,13473.0,60,22,417.53999999999996,3,3,3,9,Gold
847,13474.0,236,62,226.83999999999995,4,2,4,10,Silver
848,13475.0,191,86,1431.7800000000002,4,2,2,8,Gold
849,13476.0,178,61,1092.77,4,2,2,8,Gold
850,13477.0,37,81,1441.5300000000002,2,2,2,6,Diamond
851,13479.0,198,16,291.0,4,4,4,12,Bronze
852,13481.0,45,112,1776.81,2,1,1,4,Platinum
853,13482.0,232,11,184.64,4,4,4,12,Bronze
854,13483.0,65,10,140.34,3,4,4,11,Bronze
855,13484.0,241,8,313.8,4,4,3,11,Bronze
856,13485.0,233,23,454.24,4,3,3,10,Silver
857,13486.0,78,69,1122.4099999999999,3,2,2,7,Diamond
858,13487.0,57,34,575.4000000000001,3,3,3,9,Gold
859,13488.0,17,427,8910.61,2,1,1,4,Platinum
860,13489.0,105,14,449.52,3,4,3,10,Silver
861,13491.0,51,86,1215.8199999999997,3,2,2,7,Diamond
862,13492.0,136,50,1269.84,3,2,2,7,Diamond
863,13493.0,275,8,618.63,4,4,3,11,Bronze
864,13494.0,311,18,316.26000000000005,4,3,3,10,Silver
865,13495.0,7,52,1990.12,1,2,1,4,Platinum
866,13496.0,10,36,617.93,1,3,3,7,Diamond
867,13497.0,282,20,321.04999999999995,4,3,3,10,Silver
868,13499.0,17,45,1146.96,2,2,2,6,Diamond
869,13500.0,23,67,1136.77,2,2,2,6,Diamond
870,13501.0,242,53,1310.47,4,2,2,8,Gold
871,13502.0,16,18,291.99999999999994,1,3,3,7,Diamond
872,13503.0,71,17,216.85000000000002,3,4,4,11,Bronze
873,13504.0,64,22,295.93000000000006,3,3,3,9,Gold
874,13505.0,67,227,4282.880000000001,3,1,1,5,Platinum
875,13506.0,312,29,452.82,4,3,3,10,Silver
876,13507.0,3,162,2479.16,1,1,1,3,Platinum
877,13508.0,243,12,110.97000000000003,4,4,4,12,Bronze
878,13509.0,8,44,979.72,1,2,2,5,Platinum
879,13510.0,1,117,1785.1599999999999,1,1,1,3,Platinum
880,13512.0,260,15,251.20999999999998,4,4,4,12,Bronze
881,13513.0,126,10,205.09999999999997,3,4,4,11,Bronze
882,13514.0,73,4,152.20000000000002,3,4,4,11,Bronze
883,13515.0,72,59,891.12,3,2,2,7,Diamond
884,13516.0,21,44,1389.4100000000003,2,2,2,6,Diamond
885,13517.0,59,143,2109.0699999999997,3,1,1,5,Platinum
886,13518.0,85,36,627.1600000000001,3,3,3,9,Gold
887,13519.0,50,9,110.8,2,4,4,10,Silver
888,13520.0,58,95,3487.7499999999995,3,2,1,6,Diamond
889,13521.0,1,418,1071.73,1,1,2,4,Platinum
890,13522.0,30,5,125.80000000000001,2,4,4,10,Silver
891,13523.0,33,177,3755.38,2,1,1,4,Platinum
892,13524.0,40,27,680.1800000000001,2,3,2,7,Diamond
893,13525.0,14,6,628.78,1,4,3,8,Gold
894,13527.0,33,218,2218.61,2,1,1,4,Platinum
895,13529.0,78,15,307.76,3,4,3,10,Silver
896,13531.0,205,22,483.80000000000007,4,3,3,10,Silver
897,13532.0,33,66,210.30999999999995,2,2,4,8,Gold
898,13533.0,182,75,269.09000000000003,4,2,4,10,Silver
899,13534.0,2,342,5613.08,1,1,1,3,Platinum
900,13536.0,1,178,3444.39,1,1,1,3,Platinum
901,13538.0,43,25,1280.8500000000001,2,3,2,7,Diamond
902,13539.0,85,38,605.84,3,3,3,9,Gold
903,13544.0,39,78,276.06,2,2,4,8,Gold
904,13546.0,12,97,621.09,1,2,3,6,Diamond
905,13548.0,96,123,678.16,3,1,2,6,Diamond
906,13549.0,25,52,916.1199999999999,2,2,2,6,Diamond
907,13551.0,319,4,91.80000000000001,4,4,4,12,Bronze
908,13552.0,66,121,3539.53,3,1,1,5,Platinum
909,13555.0,73,135,4098.88,3,1,1,5,Platinum
910,13557.0,28,34,584.06,2,3,3,8,Gold
911,13558.0,5,169,594.52,1,1,3,5,Platinum
912,13560.0,7,32,171.42,1,3,4,8,Gold
913,13561.0,215,14,141.86,4,4,4,12,Bronze
914,13562.0,81,82,1799.33,3,2,1,6,Diamond
915,13563.0,84,49,777.53,3,2,2,7,Diamond
916,13564.0,144,83,623.3900000000002,4,2,3,9,Gold
917,13565.0,19,38,240.22,2,3,4,9,Gold
918,13566.0,40,169,856.8400000000001,2,1,2,5,Platinum
919,13568.0,173,43,187.04999999999998,4,2,4,10,Silver
920,13569.0,17,79,338.61999999999995,2,2,3,7,Diamond
921,13570.0,243,27,239.49000000000004,4,3,4,11,Bronze
922,13571.0,12,340,2088.94,1,1,1,3,Platinum
923,13572.0,205,33,1384.2499999999998,4,3,2,9,Gold
924,13573.0,50,25,290.25,2,3,4,9,Gold
925,13575.0,23,46,732.07,2,2,2,6,Diamond
926,13576.0,10,130,6703.300000000001,1,1,1,3,Platinum
927,13577.0,25,85,1658.3,2,2,1,5,Platinum
928,13579.0,14,23,467.0400000000001,1,3,3,7,Diamond
929,13581.0,309,10,118.0,4,4,4,12,Bronze
930,13583.0,155,53,781.03,4,2,2,8,Gold
931,13584.0,306,24,142.4,4,3,4,11,Bronze
932,13587.0,31,11,347.0,2,4,3,9,Gold
933,13588.0,15,180,2445.12,1,1,1,3,Platinum
934,13589.0,14,21,379.65000000000003,1,3,3,7,Diamond
935,13590.0,11,89,1976.12,1,2,1,4,Platinum
936,13591.0,64,58,1117.1299999999997,3,2,2,7,Diamond
937,13592.0,35,16,247.95999999999998,2,4,4,10,Silver
938,13593.0,108,128,1965.08,3,1,1,5,Platinum
939,13594.0,52,26,396.97,3,3,3,9,Gold
940,13596.0,5,146,664.11,1,1,2,4,Platinum
941,13598.0,47,36,147.29000000000005,2,3,4,9,Gold
942,13599.0,1,263,5026.85,1,1,1,3,Platinum
943,13600.0,312,19,219.51999999999998,4,3,4,11,Bronze
944,13601.0,45,99,693.32,2,2,2,6,Diamond
945,13602.0,64,23,428.89,3,3,3,9,Gold
946,13603.0,26,27,164.34,2,3,4,9,Gold
947,13606.0,29,40,276.75,2,3,4,9,Gold
948,13607.0,40,97,675.5100000000001,2,2,2,6,Diamond
949,13610.0,12,217,1065.8799999999999,1,1,2,4,Platinum
950,13611.0,89,74,1140.7999999999997,3,2,2,7,Diamond
951,13614.0,24,195,1585.46,2,1,2,5,Platinum
952,13615.0,312,24,399.99,4,3,3,10,Silver
953,13617.0,40,44,544.1800000000001,2,2,3,7,Diamond
954,13618.0,173,13,177.34,4,4,4,12,Bronze
955,13621.0,116,19,213.85,3,3,4,10,Silver
956,13623.0,30,83,652.4000000000001,2,2,2,6,Diamond
957,13626.0,252,19,257.22999999999996,4,3,4,11,Bronze
958,13627.0,59,94,1624.0200000000002,3,2,1,6,Diamond
959,13629.0,23,59,7792.360000000001,2,2,1,5,Platinum
960,13630.0,5,80,1995.6799999999998,1,2,1,4,Platinum
961,13631.0,99,12,3021.77,3,4,1,8,Gold
962,13632.0,24,146,2114.68,2,1,1,4,Platinum
963,13634.0,33,186,1547.3599999999997,2,1,2,5,Platinum
964,13635.0,67,62,1071.03,3,2,2,7,Diamond
965,13636.0,36,64,941.62,2,2,2,6,Diamond
966,13637.0,52,99,804.3,3,2,2,7,Diamond
967,13638.0,15,8,122.64,1,4,4,9,Gold
968,13639.0,74,40,1033.3400000000001,3,3,2,8,Gold
969,13642.0,215,57,312.28000000000003,4,2,3,9,Gold
970,13643.0,31,28,519.44,2,3,3,8,Gold
971,13644.0,8,148,2597.5200000000004,1,1,1,3,Platinum
972,13645.0,120,5,252.1,3,4,4,11,Bronze
973,13647.0,9,79,1640.2200000000003,1,2,1,4,Platinum
974,13649.0,256,23,346.6,4,3,3,10,Silver
975,13650.0,16,98,1809.34,1,2,1,4,Platinum
976,13651.0,35,6,94.2,2,4,4,10,Silver
977,13652.0,45,63,1095.08,2,2,2,6,Diamond
978,13654.0,43,166,2707.33,2,1,1,4,Platinum
979,13655.0,114,56,932.97,3,2,2,7,Diamond
980,13656.0,164,49,379.65000000000003,4,2,3,9,Gold
981,13657.0,10,16,382.14,1,4,3,8,Gold
982,13658.0,9,112,2421.47,1,1,1,3,Platinum
983,13659.0,197,107,1540.65,4,1,2,7,Diamond
984,13662.0,85,57,862.5799999999999,3,2,2,7,Diamond
985,13663.0,179,13,189.46999999999997,4,4,4,12,Bronze
986,13666.0,60,12,84.65,3,4,4,11,Bronze
987,13667.0,149,83,299.04999999999995,4,2,3,9,Gold
988,13668.0,2,494,6162.3099999999995,1,1,1,3,Platinum
989,13669.0,50,9,218.55,2,4,4,10,Silver
990,13670.0,75,25,349.7,3,3,3,9,Gold
991,13672.0,301,16,-71.45999999999998,4,4,4,12,Bronze
992,13673.0,18,60,387.44000000000005,2,2,3,7,Diamond
993,13675.0,151,25,486.82000000000005,4,3,3,10,Silver
994,13678.0,151,16,232.6,4,4,4,12,Bronze
995,13680.0,1,215,2199.01,1,1,1,3,Platinum
996,13681.0,17,57,827.83,2,2,2,6,Diamond
997,13682.0,187,3,59.5,4,4,4,12,Bronze
998,13684.0,285,30,62.13000000000001,4,3,4,11,Bronze
999,13685.0,2,39,3119.44,1,3,1,5,Platinum
1000,13686.0,182,8,72.0,4,4,4,12,Bronze
1001,13689.0,63,6,910.0,3,4,2,9,Gold
1002,13690.0,59,9,172.25,3,4,4,11,Bronze
1003,13692.0,24,55,1466.8699999999997,2,2,2,6,Diamond
1004,13693.0,325,4,-32.0,4,4,4,12,Bronze
1005,13694.0,3,584,62690.54,1,1,1,3,Platinum
1006,13695.0,31,90,2504.13,2,2,1,5,Platinum
1007,13697.0,38,12,151.3,2,4,4,10,Silver
1008,13699.0,155,14,308.58,4,4,3,11,Bronze
1009,13700.0,26,194,2248.63,2,1,1,4,Platinum
1010,13703.0,318,1,99.5,4,4,4,12,Bronze
1011,13704.0,5,135,2295.3100000000004,1,1,1,3,Platinum
1012,13705.0,7,28,711.86,1,3,2,6,Diamond
1013,13706.0,302,20,330.79,4,3,3,10,Silver
1014,13707.0,267,48,806.41,4,2,2,8,Gold
1015,13708.0,271,49,285.3299999999999,4,2,4,10,Silver
1016,13709.0,3,345,6228.71,1,1,1,3,Platinum
1017,13710.0,31,8,180.48,2,4,4,10,Silver
1018,13711.0,218,13,252.06000000000003,4,4,4,12,Bronze
1019,13712.0,246,10,228.83999999999997,4,4,4,12,Bronze
1020,13715.0,281,107,1051.99,4,1,2,7,Diamond
1021,13716.0,269,21,138.28,4,3,4,11,Bronze
1022,13717.0,32,103,1432.2600000000002,2,1,2,5,Platinum
1023,13718.0,246,12,306.55,4,4,3,11,Bronze
1024,13719.0,15,60,1041.68,1,2,2,5,Platinum
1025,13720.0,116,43,799.9,3,2,2,7,Diamond
1026,13721.0,36,28,524.1400000000001,2,3,3,8,Gold
1027,13722.0,120,86,2369.16,3,2,1,6,Diamond
1028,13723.0,217,6,199.85000000000002,4,4,4,12,Bronze
1029,13725.0,49,118,1809.8099999999997,2,1,1,4,Platinum
1030,13726.0,38,42,1079.6599999999999,2,2,2,6,Diamond
1031,13727.0,28,20,333.48,2,3,3,8,Gold
1032,13728.0,36,63,1016.1400000000001,2,2,2,6,Diamond
1033,13730.0,135,43,752.6,3,2,2,7,Diamond
1034,13731.0,219,38,610.59,4,3,3,10,Silver
1035,13732.0,28,33,491.86000000000007,2,3,3,8,Gold
1036,13735.0,24,207,2764.4799999999996,2,1,1,4,Platinum
1037,13736.0,5,193,721.9000000000001,1,1,2,4,Platinum
1038,13737.0,200,30,339.6,4,3,3,10,Silver
1039,13739.0,18,3,216.9,2,4,4,10,Silver
1040,13740.0,240,23,350.75,4,3,3,10,Silver
1041,13741.0,71,35,666.33,3,3,2,8,Gold
1042,13742.0,16,315,3079.27,1,1,1,3,Platinum
1043,13743.0,2,42,1340.15,1,2,2,5,Platinum
1044,13744.0,95,63,1080.52,3,2,2,7,Diamond
1045,13745.0,151,26,291.53999999999996,4,3,4,11,Bronze
1046,13747.0,373,1,79.6,4,4,4,12,Bronze
1047,13748.0,95,28,948.2499999999999,3,3,2,8,Gold
1048,13750.0,53,24,1647.26,3,3,1,7,Diamond
1049,13751.0,288,9,296.25,4,4,3,11,Bronze
1050,13752.0,124,75,1175.3799999999999,3,2,2,7,Diamond
1051,13753.0,287,35,741.26,4,3,2,9,Gold
1052,13754.0,151,12,282.6,4,4,4,12,Bronze
1053,13755.0,3,322,2101.3900000000003,1,1,1,3,Platinum
1054,13756.0,2,143,5145.120000000001,1,1,1,3,Platinum
1055,13758.0,11,117,3190.55,1,1,1,3,Platinum
1056,13759.0,33,25,659.41,2,3,2,7,Diamond
1057,13760.0,54,57,286.78999999999996,3,2,4,9,Gold
1058,13761.0,50,70,1070.65,2,2,2,6,Diamond
1059,13762.0,204,14,-1.4210854715202004e-14,4,4,4,12,Bronze
1060,13763.0,63,17,1689.46,3,4,1,8,Gold
1061,13764.0,70,207,1519.42,3,1,2,6,Diamond
1062,13767.0,2,399,16945.71,1,1,1,3,Platinum
1063,13769.0,2,143,2771.87,1,1,1,3,Platinum
1064,13771.0,64,120,2631.7,3,1,1,5,Platinum
1065,13772.0,33,173,1122.63,2,1,2,5,Platinum
1066,13774.0,81,22,345.0,3,3,3,9,Gold
1067,13777.0,0,219,25748.350000000002,1,1,1,3,Platinum
1068,13778.0,103,9,178.7,3,4,4,11,Bronze
1069,13780.0,7,57,360.01000000000005,1,2,3,6,Diamond
1070,13781.0,250,17,127.84,4,4,4,12,Bronze
1071,13782.0,12,113,908.8599999999999,1,1,2,4,Platinum
1072,13784.0,9,31,2462.7899999999995,1,3,1,5,Platinum
1073,13786.0,367,7,230.4,4,4,4,12,Bronze
1074,13787.0,75,31,309.04,3,3,3,9,Gold
1075,13790.0,4,45,348.79999999999995,1,2,3,6,Diamond
1076,13791.0,43,17,1047.68,2,4,2,8,Gold
1077,13792.0,66,13,195.54999999999995,3,4,4,11,Bronze
1078,13798.0,1,438,36352.87,1,1,1,3,Platinum
1079,13799.0,116,39,688.8600000000001,3,3,2,8,Gold
1080,13800.0,309,33,558.32,4,3,3,10,Silver
1081,13801.0,66,23,324.79999999999995,3,3,3,9,Gold
1082,13802.0,138,66,3906.2699999999995,3,2,1,6,Diamond
1083,13803.0,255,17,277.07000000000005,4,4,4,12,Bronze
1084,13804.0,30,135,2588.39,2,1,1,4,Platinum
1085,13805.0,52,13,924.5999999999999,3,4,2,9,Gold
1086,13806.0,63,10,256.38,3,4,4,11,Bronze
1087,13807.0,367,7,112.6,4,4,4,12,Bronze
1088,13808.0,5,76,1747.6600000000003,1,2,1,4,Platinum
1089,13809.0,305,12,155.05,4,4,4,12,Bronze
1090,13810.0,28,36,899.51,2,3,2,7,Diamond
1091,13811.0,183,14,591.75,4,4,3,11,Bronze
1092,13812.0,42,36,539.0,2,3,3,8,Gold
1093,13813.0,39,71,1353.4099999999999,2,2,2,6,Diamond
1094,13814.0,56,58,1562.1200000000001,3,2,2,7,Diamond
1095,13815.0,22,177,4014.91,2,1,1,4,Platinum
1096,13816.0,23,33,555.04,2,3,3,8,Gold
1097,13817.0,29,24,382.97999999999996,2,3,3,8,Gold
1098,13819.0,301,36,1140.35,4,3,2,9,Gold
1099,13821.0,144,59,385.64,4,2,3,9,Gold
1100,13822.0,5,96,632.0,1,2,3,6,Diamond
1101,13823.0,18,40,957.66,2,3,2,7,Diamond
1102,13824.0,32,46,1698.94,2,2,1,5,Platinum
1103,13826.0,158,12,174.65,4,4,4,12,Bronze
1104,13827.0,57,92,409.8,3,2,3,8,Gold
1105,13828.0,22,15,209.49000000000004,2,4,4,10,Silver
1106,13829.0,359,1,-102.0,4,4,4,12,Bronze
1107,13831.0,16,72,2198.45,1,2,1,4,Platinum
1108,13832.0,17,4,40.949999999999996,2,4,4,10,Silver
1109,13833.0,159,28,383.8499999999999,4,3,3,10,Silver
1110,13835.0,25,55,834.57,2,2,2,6,Diamond
1111,13837.0,211,18,266.59000000000003,4,3,4,11,Bronze
1112,13838.0,5,165,674.82,1,1,2,4,Platinum
1113,13841.0,252,1,85.0,4,4,4,12,Bronze
1114,13842.0,58,206,3385.6200000000003,3,1,1,5,Platinum
1115,13844.0,11,20,361.62,1,3,3,7,Diamond
1116,13845.0,64,9,312.98,3,4,3,10,Silver
1117,13846.0,24,58,847.6099999999999,2,2,2,6,Diamond
1118,13848.0,92,5,1255.0,3,4,2,9,Gold
1119,13849.0,51,101,1537.95,3,1,2,6,Diamond
1120,13850.0,88,94,1586.8100000000002,3,2,2,7,Diamond
1121,13851.0,95,81,2651.4599999999996,3,2,1,6,Diamond
1122,13853.0,8,24,1056.94,1,3,2,6,Diamond
1123,13854.0,8,114,8025.0199999999995,1,1,1,3,Platinum
1124,13856.0,168,17,363.4,4,4,3,11,Bronze
1125,13858.0,57,11,216.17000000000002,3,4,4,11,Bronze
1126,13859.0,326,28,201.16,4,3,4,11,Bronze
1127,13860.0,1,77,1240.0000000000002,1,2,2,5,Platinum
1128,13862.0,18,142,2187.3100000000004,2,1,1,4,Platinum
1129,13863.0,245,22,299.55999999999995,4,3,3,10,Silver
1130,13865.0,58,30,501.56,3,3,3,9,Gold
1131,13866.0,74,7,145.67,3,4,4,11,Bronze
1132,13867.0,31,60,1005.0899999999999,2,2,2,6,Diamond
1133,13868.0,7,33,3192.54,1,3,1,5,Platinum
1134,13869.0,123,304,3083.65,3,1,1,5,Platinum
1135,13870.0,2,118,2751.2500000000005,1,1,1,3,Platinum
1136,13871.0,22,338,6389.8,2,1,1,4,Platinum
1137,13873.0,119,24,381.7,3,3,3,9,Gold
1138,13874.0,358,18,540.45,4,3,3,10,Silver
1139,13875.0,53,104,1786.79,3,1,1,5,Platinum
1140,13876.0,63,7,122.69999999999999,3,4,4,11,Bronze
1141,13877.0,86,3,117.24000000000001,3,4,4,11,Bronze
1142,13878.0,54,35,1271.5699999999997,3,3,2,8,Gold
1143,13880.0,21,165,3219.7700000000004,2,1,1,4,Platinum
1144,13881.0,3,180,16989.52,1,1,1,3,Platinum
1145,13882.0,2,66,1131.28,1,2,2,5,Platinum
1146,13883.0,1,155,2538.75,1,1,1,3,Platinum
1147,13884.0,7,60,781.3000000000002,1,2,2,5,Platinum
1148,13885.0,189,28,506.8,4,3,3,10,Silver
1149,13886.0,71,16,243.56,3,4,4,11,Bronze
1150,13887.0,204,19,349.54999999999995,4,3,3,10,Silver
1151,13888.0,119,39,595.67,3,3,3,9,Gold
1152,13889.0,92,15,416.9,3,4,3,10,Silver
1153,13890.0,1,114,1860.8600000000001,1,1,1,3,Platinum
1154,13892.0,26,27,632.97,2,3,3,8,Gold
1155,13893.0,297,21,821.1000000000001,4,3,2,9,Gold
1156,13894.0,22,30,535.97,2,3,3,8,Gold
1157,13895.0,21,119,2588.12,2,1,1,4,Platinum
1158,13897.0,50,17,311.15999999999997,2,4,3,9,Gold
1159,13898.0,325,12,155.93,4,4,4,12,Bronze
1160,13899.0,16,19,388.52,1,3,3,7,Diamond
1161,13900.0,183,43,740.9499999999999,4,2,2,8,Gold
1162,13901.0,72,149,2867.2,3,1,1,5,Platinum
1163,13904.0,37,26,332.64000000000004,2,3,3,8,Gold
1164,13908.0,79,126,2347.0499999999997,3,1,1,5,Platinum
1165,13911.0,57,148,2580.91,3,1,1,5,Platinum
1166,13914.0,3,34,613.95,1,3,3,7,Diamond
1167,13917.0,49,18,272.03999999999996,2,3,4,9,Gold
1168,13918.0,49,30,1212.8400000000004,2,3,2,7,Diamond
1169,13919.0,53,33,350.16,3,3,3,9,Gold
1170,13922.0,351,7,172.24999999999997,4,4,4,12,Bronze
1171,13923.0,53,20,351.13000000000005,3,3,3,9,Gold
1172,13924.0,1,137,1682.08,1,1,1,3,Platinum
1173,13925.0,36,45,616.65,2,2,3,7,Diamond
1174,13926.0,23,11,223.85000000000002,2,4,4,10,Silver
1175,13927.0,74,21,348.99000000000007,3,3,3,9,Gold
1176,13928.0,10,27,464.57,1,3,3,7,Diamond
1177,13929.0,169,10,802.85,4,4,2,10,Silver
1178,13930.0,57,17,337.34,3,4,3,10,Silver
1179,13931.0,85,59,1230.93,3,2,2,7,Diamond
1180,13932.0,294,16,307.4,4,4,3,11,Bronze
1181,13933.0,109,23,608.7899999999998,3,3,3,9,Gold
1182,13934.0,263,31,922.0999999999999,4,3,2,9,Gold
1183,13936.0,171,27,361.2799999999999,4,3,3,10,Silver
1184,13937.0,169,9,158.85,4,4,4,12,Bronze
1185,13938.0,35,7,71.66,2,4,4,10,Silver
1186,13939.0,23,46,556.7499999999999,2,2,3,7,Diamond
1187,13940.0,17,49,839.14,2,2,2,6,Diamond
1188,13941.0,21,47,4912.409999999999,2,2,1,5,Platinum
1189,13946.0,79,11,561.57,3,4,3,10,Silver
1190,13947.0,65,5,90.6,3,4,4,11,Bronze
1191,13948.0,360,3,101.99999999999999,4,4,4,12,Bronze
1192,13949.0,2,160,2427.3199999999997,1,1,1,3,Platinum
1193,13950.0,11,36,728.5600000000001,1,3,2,6,Diamond
1194,13951.0,176,39,674.4499999999998,4,3,2,9,Gold
1195,13952.0,211,138,3246.091,4,1,1,6,Diamond
1196,13953.0,7,20,3515.6799999999994,1,3,1,5,Platinum
1197,13954.0,1,30,378.59,1,3,3,7,Diamond
1198,13955.0,154,33,322.96,4,3,3,10,Silver
1199,13956.0,5,147,1019.2700000000001,1,1,2,4,Platinum
1200,13958.0,372,5,-102.45,4,4,4,12,Bronze
1201,13959.0,79,90,594.04,3,2,3,8,Gold
1202,13960.0,21,12,230.22,2,4,4,10,Silver
1203,13962.0,21,11,169.55,2,4,4,10,Silver
1204,13963.0,308,35,664.5400000000001,4,3,2,9,Gold
1205,13967.0,145,2,80.7,4,4,4,12,Bronze
1206,13969.0,7,626,8956.92,1,1,1,3,Platinum
1207,13971.0,8,158,2702.2200000000003,1,1,1,3,Platinum
1208,13972.0,70,15,190.25000000000003,3,4,4,11,Bronze
1209,13973.0,287,11,264.7,4,4,4,12,Bronze
1210,13974.0,49,28,413.59,2,3,3,8,Gold
1211,13975.0,31,331,2438.1899999999996,2,1,1,4,Platinum
1212,13976.0,206,10,357.98,4,4,3,11,Bronze
1213,13978.0,14,15,196.79,1,4,4,9,Gold
1214,13979.0,73,54,869.8699999999998,3,2,2,7,Diamond
1215,13980.0,60,11,200.14000000000001,3,4,4,11,Bronze
1216,13982.0,39,115,1861.11,2,1,1,4,Platinum
1217,13983.0,29,112,2590.46,2,1,1,4,Platinum
1218,13984.0,26,17,488.03,2,4,3,9,Gold
1219,13985.0,4,353,7024.530000000001,1,1,1,3,Platinum
1220,13986.0,17,13,320.46000000000004,2,4,3,9,Gold
1221,13988.0,19,239,4098.8,2,1,1,4,Platinum
1222,13989.0,65,41,1266.08,3,3,2,8,Gold
1223,13990.0,213,16,311.3,4,4,3,11,Bronze
1224,13991.0,12,84,847.5400000000001,1,2,2,5,Platinum
1225,13992.0,30,5,76.8,2,4,4,10,Silver
1226,13993.0,32,125,3409.6600000000003,2,1,1,4,Platinum
1227,13994.0,3,148,2274.1400000000003,1,1,1,3,Platinum
1228,13995.0,15,87,1383.49,1,2,2,5,Platinum
1229,13999.0,10,212,3865.26,1,1,1,3,Platinum
1230,14000.0,206,16,633.71,4,4,3,11,Bronze
1231,14001.0,45,40,2030.33,2,3,1,6,Diamond
1232,14002.0,134,47,529.7299999999999,3,2,3,8,Gold
1233,14004.0,43,171,4582.639999999999,2,1,1,4,Platinum
1234,14005.0,9,84,2874.72,1,2,1,4,Platinum
1235,14006.0,115,30,962.1899999999999,3,3,2,8,Gold
1236,14009.0,198,44,685.9299999999998,4,2,2,8,Gold
1237,14012.0,277,11,328.8,4,4,3,11,Bronze
1238,14013.0,110,34,473.02,3,3,3,9,Gold
1239,14014.0,77,39,505.18,3,3,3,9,Gold
1240,14015.0,52,20,917.34,3,3,2,8,Gold
1241,14016.0,154,162,4328.46,4,1,1,6,Diamond
1242,14019.0,46,68,1398.9599999999998,2,2,2,6,Diamond
1243,14020.0,16,39,642.8000000000001,1,3,3,7,Diamond
1244,14021.0,155,22,631.9000000000001,4,3,3,10,Silver
1245,14022.0,225,28,440.0,4,3,3,10,Silver
1246,14023.0,7,31,584.0699999999999,1,3,3,7,Diamond
1247,14024.0,121,16,327.70000000000005,3,4,3,10,Silver
1248,14027.0,60,6,104.82000000000002,3,4,4,11,Bronze
1249,14029.0,63,15,467.66,3,4,3,10,Silver
1250,14030.0,18,242,2358.8399999999997,2,1,1,4,Platinum
1251,14031.0,7,258,14634.640000000001,1,1,1,3,Platinum
1252,14032.0,2,152,2929.8399999999997,1,1,1,3,Platinum
1253,14034.0,22,89,509.09000000000003,2,2,3,7,Diamond
1254,14035.0,28,66,1428.0200000000002,2,2,2,6,Diamond
1255,14036.0,284,38,626.65,4,3,3,10,Silver
1256,14037.0,176,28,147.2,4,3,4,11,Bronze
1257,14038.0,78,93,1554.4799999999996,3,2,2,7,Diamond
1258,14039.0,33,6,152.2,2,4,4,10,Silver
1259,14040.0,40,235,3487.59,2,1,1,4,Platinum
1260,14041.0,266,21,141.41,4,3,4,11,Bronze
1261,14044.0,26,206,646.4200000000001,2,1,2,5,Platinum
1262,14045.0,109,6,1659.75,3,4,1,8,Gold
1263,14046.0,284,14,154.99,4,4,4,12,Bronze
1264,14047.0,8,34,1290.0099999999998,1,3,2,6,Diamond
1265,14048.0,277,88,375.13,4,2,3,9,Gold
1266,14049.0,16,495,5536.15,1,1,1,3,Platinum
1267,14050.0,31,54,746.3599999999999,2,2,2,6,Diamond
1268,14051.0,0,215,15477.34,1,1,1,3,Platinum
1269,14052.0,19,56,225.36,2,2,4,8,Gold
1270,14053.0,124,4,260.25,3,4,4,11,Bronze
1271,14054.0,65,6,92.46,3,4,4,11,Bronze
1272,14055.0,106,10,725.6400000000001,3,4,2,9,Gold
1273,14056.0,1,1110,8062.460000000001,1,1,1,3,Platinum
1274,14057.0,23,290,6141.099999999999,2,1,1,4,Platinum
1275,14059.0,266,8,183.6,4,4,4,12,Bronze
1276,14060.0,4,203,6135.38,1,1,1,3,Platinum
1277,14062.0,9,111,10464.850000000002,1,1,1,3,Platinum
1278,14064.0,29,79,1168.9199999999998,2,2,2,6,Diamond
1279,14066.0,266,7,152.55,4,4,4,12,Bronze
1280,14067.0,63,52,374.7,3,2,3,8,Gold
1281,14068.0,320,24,265.85,4,3,4,11,Bronze
1282,14071.0,3,332,1306.1599999999999,1,1,2,4,Platinum
1283,14073.0,21,14,139.54,2,4,4,10,Silver
1284,14075.0,4,43,942.26,1,2,2,5,Platinum
1285,14076.0,129,44,118.67,3,2,4,9,Gold
1286,14077.0,40,42,499.4200000000001,2,2,3,7,Diamond
1287,14078.0,101,65,1049.37,3,2,2,7,Diamond
1288,14079.0,124,12,375.0999999999999,3,4,3,10,Silver
1289,14080.0,32,4,45.599999999999994,2,4,4,10,Silver
1290,14081.0,267,153,891.77,4,1,2,7,Diamond
1291,14082.0,364,29,182.24999999999997,4,3,4,11,Bronze
1292,14083.0,4,177,1002.9000000000001,1,1,2,4,Platinum
1293,14085.0,2,449,4408.540000000001,1,1,1,3,Platinum
1294,14087.0,2,69,178.72,1,2,4,7,Diamond
1295,14088.0,10,590,50415.490000000005,1,1,1,3,Platinum
1296,14089.0,56,13,158.75,3,4,4,11,Bronze
1297,14090.0,324,1,76.32000000000001,4,4,4,12,Bronze
1298,14092.0,7,217,4063.1000000000004,1,1,1,3,Platinum
1299,14093.0,12,100,433.85999999999996,1,1,3,5,Platinum
1300,14096.0,4,5128,57120.91,1,1,1,3,Platinum
1301,14098.0,36,21,147.34999999999997,2,3,4,9,Gold
1302,14099.0,16,252,3092.97,1,1,1,3,Platinum
1303,14100.0,137,25,191.95000000000002,3,3,4,10,Silver
1304,14101.0,73,35,5976.790000000001,3,3,1,7,Diamond
1305,14102.0,5,63,1060.33,1,2,2,5,Platinum
1306,14104.0,154,21,216.20999999999998,4,3,4,11,Bronze
1307,14105.0,85,76,1260.33,3,2,2,7,Diamond
1308,14107.0,51,124,2688.48,3,1,1,5,Platinum
1309,14108.0,30,35,594.1600000000001,2,3,3,8,Gold
1310,14109.0,23,14,80.19999999999999,2,4,4,10,Silver
1311,14110.0,3,157,5669.650000000001,1,1,1,3,Platinum
1312,14111.0,14,11,688.6,1,4,2,7,Diamond
1313,14112.0,22,173,2774.17,2,1,1,4,Platinum
1314,14113.0,3,40,1377.92,1,3,2,6,Diamond
1315,14114.0,273,15,386.53,4,4,3,11,Bronze
1316,14116.0,19,72,1382.7399999999998,2,2,2,6,Diamond
1317,14117.0,143,3,90.0,3,4,4,11,Bronze
1318,14119.0,354,1,-19.9,4,4,4,12,Bronze
1319,14121.0,3,161,2740.3,1,1,1,3,Platinum
1320,14124.0,84,5,419.58000000000004,3,4,3,10,Silver
1321,14125.0,10,166,2720.63,1,1,1,3,Platinum
1322,14126.0,7,16,643.6300000000001,1,4,3,8,Gold
1323,14127.0,122,44,709.7099999999999,3,2,2,7,Diamond
1324,14128.0,60,46,637.5000000000002,3,2,3,8,Gold
1325,14129.0,1,52,1123.8600000000001,1,2,2,5,Platinum
1326,14130.0,319,66,480.9100000000001,4,2,3,9,Gold
1327,14132.0,2,201,3580.13,1,1,1,3,Platinum
1328,14133.0,129,30,590.3399999999999,3,3,3,9,Gold
1329,14135.0,1,134,4690.3099999999995,1,1,1,3,Platinum
1330,14138.0,1,46,965.8800000000002,1,2,2,5,Platinum
1331,14139.0,46,26,415.81999999999994,2,3,3,8,Gold
1332,14140.0,3,67,920.05,1,2,2,5,Platinum
1333,14141.0,2,46,879.03,1,2,2,5,Platinum
1334,14142.0,373,22,311.81,4,3,3,10,Silver
1335,14143.0,133,7,115.8,3,4,4,11,Bronze
1336,14145.0,46,12,3148.2,2,4,1,7,Diamond
1337,14146.0,8,245,2949.57,1,1,1,3,Platinum
1338,14147.0,49,6,468.4,2,4,3,9,Gold
1339,14148.0,233,3,157.2,4,4,4,12,Bronze
1340,14149.0,212,40,259.43,4,3,4,11,Bronze
1341,14150.0,35,26,658.64,2,3,2,7,Diamond
1342,14152.0,75,50,611.09,3,2,3,8,Gold
1343,14154.0,239,52,1345.62,4,2,2,8,Gold
1344,14155.0,266,6,118.75,4,4,4,12,Bronze
1345,14156.0,9,1415,113214.59,1,1,1,3,Platinum
1346,14157.0,19,47,392.44000000000005,2,2,3,7,Diamond
1347,14158.0,40,41,507.65999999999997,2,3,3,8,Gold
1348,14159.0,19,1183,4615.639999999999,2,1,1,4,Platinum
1349,14161.0,215,104,1097.62,4,1,2,7,Diamond
1350,14162.0,173,25,289.36,4,3,4,11,Bronze
1351,14163.0,87,52,2445.9100000000003,3,2,1,6,Diamond
1352,14164.0,70,29,1631.7700000000004,3,3,1,7,Diamond
1353,14165.0,275,24,120.44,4,3,4,11,Bronze
1354,14167.0,39,50,562.59,2,2,3,7,Diamond
1355,14171.0,98,58,363.79,3,2,3,8,Gold
1356,14173.0,10,29,450.8400000000001,1,3,3,7,Diamond
1357,14174.0,33,26,134.46,2,3,4,9,Gold
1358,14175.0,51,164,3108.0600000000004,3,1,1,5,Platinum
1359,14176.0,297,32,574.0,4,3,3,10,Silver
1360,14177.0,84,42,544.51,3,2,3,8,Gold
1361,14178.0,8,318,1600.2600000000002,1,1,2,4,Platinum
1362,14179.0,40,157,701.5699999999999,2,1,2,5,Platinum
1363,14180.0,10,248,4640.77,1,1,1,3,Platinum
1364,14184.0,66,24,452.89,3,3,3,9,Gold
1365,14185.0,331,3,197.65,4,4,4,12,Bronze
1366,14188.0,8,71,2018.9099999999999,1,2,1,4,Platinum
1367,14189.0,2,277,4604.3099999999995,1,1,1,3,Platinum
1368,14191.0,1,263,4660.01,1,1,1,3,Platinum
1369,14193.0,67,42,853.3900000000001,3,2,2,7,Diamond
1370,14194.0,4,604,11216.75,1,1,1,3,Platinum
1371,14195.0,201,8,962.7,4,4,2,10,Silver
1372,14196.0,106,6,335.52,3,4,3,10,Silver
1373,14198.0,4,44,663.4999999999999,1,2,2,5,Platinum
1374,14199.0,218,2,185.39999999999998,4,4,4,12,Bronze
1375,14201.0,60,39,688.0400000000001,3,3,2,8,Gold
1376,14204.0,2,39,150.60999999999996,1,3,4,8,Gold
1377,14205.0,10,39,218.78,1,3,4,8,Gold
1378,14206.0,239,21,308.26,4,3,3,10,Silver
1379,14208.0,94,10,151.73999999999998,3,4,4,11,Bronze
1380,14209.0,10,88,2067.13,1,2,1,4,Platinum
1381,14210.0,91,103,1900.89,3,1,1,5,Platinum
1382,14211.0,53,118,2208.3,3,1,1,5,Platinum
1383,14212.0,89,9,1070.48,3,4,2,9,Gold
1384,14213.0,371,5,-1192.2000000000003,4,4,4,12,Bronze
1385,14214.0,30,70,1000.2300000000001,2,2,2,6,Diamond
1386,14215.0,11,109,1777.92,1,1,1,3,Platinum
1387,14216.0,3,59,1839.3000000000002,1,2,1,4,Platinum
1388,14217.0,1,107,1925.36,1,1,1,3,Platinum
1389,14218.0,42,12,169.48000000000002,2,4,4,10,Silver
1390,14219.0,4,7,89.94,1,4,4,9,Gold
1391,14220.0,247,21,632.3999999999999,4,3,3,10,Silver
1392,14221.0,42,194,3427.85,2,1,1,4,Platinum
1393,14222.0,177,41,683.1700000000001,4,3,2,9,Gold
1394,14223.0,92,61,975.23,3,2,2,7,Diamond
1395,14224.0,110,113,1009.73,3,1,2,6,Diamond
1396,14226.0,28,72,2184.24,2,2,1,5,Platinum
1397,14227.0,26,183,3315.7100000000005,2,1,1,4,Platinum
1398,14229.0,51,43,1450.6000000000001,3,2,2,7,Diamond
1399,14231.0,179,54,822.0600000000001,4,2,2,8,Gold
1400,14232.0,31,118,2043.93,2,1,1,4,Platinum
1401,14233.0,43,36,1447.5100000000002,2,3,2,7,Diamond
1402,14234.0,22,147,754.1200000000001,2,1,2,5,Platinum
1403,14235.0,10,80,3093.86,1,2,1,4,Platinum
1404,14236.0,80,15,490.86,3,4,3,10,Silver
1405,14237.0,373,9,161.00000000000003,4,4,4,12,Bronze
1406,14238.0,326,8,146.85,4,4,4,12,Bronze
1407,14239.0,43,116,2323.5000000000005,2,1,1,4,Platinum
1408,14240.0,30,42,890.3400000000001,2,2,2,6,Diamond
1409,14241.0,183,10,213.70000000000005,4,4,4,12,Bronze
1410,14242.0,234,16,280.55,4,4,4,12,Bronze
1411,14243.0,8,148,2535.88,1,1,1,3,Platinum
1412,14245.0,176,112,1677.48,4,1,1,6,Diamond
1413,14246.0,110,75,1474.0600000000002,3,2,2,7,Diamond
1414,14247.0,278,20,136.76999999999998,4,3,4,11,Bronze
1415,14248.0,318,8,302.58,4,4,3,11,Bronze
1416,14250.0,7,111,1904.05,1,1,1,3,Platinum
1417,14251.0,1,78,2879.7,1,2,1,4,Platinum
1418,14256.0,254,54,935.06,4,2,2,8,Gold
1419,14257.0,51,107,3087.2700000000004,3,1,1,5,Platinum
1420,14258.0,9,112,12650.080000000002,1,1,1,3,Platinum
1421,14259.0,141,5,120.0,3,4,4,11,Bronze
1422,14261.0,50,52,1163.45,2,2,2,6,Diamond
1423,14262.0,8,143,2618.2299999999996,1,1,1,3,Platinum
1424,14264.0,154,19,319.47,4,3,3,10,Silver
1425,14265.0,109,31,530.18,3,3,3,9,Gold
1426,14267.0,150,66,1279.0900000000001,4,2,2,8,Gold
1427,14270.0,331,29,492.65,4,3,3,10,Silver
1428,14271.0,225,10,112.32,4,4,4,12,Bronze
1429,14272.0,73,33,437.96000000000004,3,3,3,9,Gold
1430,14273.0,51,29,559.97,3,3,3,9,Gold
1431,14276.0,88,75,1019.3900000000001,3,2,2,7,Diamond
1432,14277.0,15,225,3928.7999999999997,1,1,1,3,Platinum
1433,14280.0,196,8,134.04,4,4,4,12,Bronze
1434,14282.0,3,154,3701.4400000000005,1,1,1,3,Platinum
1435,14284.0,30,34,578.45,2,3,3,8,Gold
1436,14285.0,21,27,1910.0100000000002,2,3,1,6,Diamond
1437,14286.0,23,285,4595.81,2,1,1,4,Platinum
1438,14287.0,8,11,151.23,1,4,4,9,Gold
1439,14288.0,212,17,413.85,4,4,3,11,Bronze
1440,14289.0,8,47,911.26,1,2,2,5,Platinum
1441,14290.0,11,103,2307.45,1,1,1,3,Platinum
1442,14291.0,1,238,3873.3,1,1,1,3,Platinum
1443,14292.0,7,108,4819.329999999999,1,1,1,3,Platinum
1444,14293.0,3,61,1046.56,1,2,2,5,Platinum
1445,14295.0,40,7,154.7,2,4,4,10,Silver
1446,14297.0,17,64,1284.06,2,2,2,6,Diamond
1447,14298.0,3,1640,50862.44,1,1,1,3,Platinum
1448,14299.0,8,162,2855.3500000000004,1,1,1,3,Platinum
1449,14300.0,18,3,43.2,2,4,4,10,Silver
1450,14301.0,107,16,632.04,3,4,3,10,Silver
1451,14304.0,222,27,197.1,4,3,4,11,Bronze
1452,14305.0,71,110,1803.76,3,1,1,5,Platinum
1453,14306.0,51,35,2083.42,3,3,1,7,Diamond
1454,14307.0,88,180,2995.72,3,1,1,5,Platinum
1455,14309.0,8,123,2319.6800000000003,1,1,1,3,Platinum
1456,14311.0,225,27,229.71000000000004,4,3,4,11,Bronze
1457,14312.0,46,87,1611.59,2,2,1,5,Platinum
1458,14314.0,106,8,120.0,3,4,4,11,Bronze
1459,14315.0,21,104,2456.9800000000005,2,1,1,4,Platinum
1460,14317.0,64,24,508.58,3,3,3,9,Gold
1461,14320.0,206,42,343.10999999999996,4,2,3,9,Gold
1462,14321.0,10,123,1530.7500000000002,1,1,2,4,Platinum
1463,14323.0,114,41,574.26,3,3,3,9,Gold
1464,14326.0,234,9,166.85000000000002,4,4,4,12,Bronze
1465,14327.0,163,12,311.65000000000003,4,4,3,11,Bronze
1466,14329.0,8,268,4889.139999999999,1,1,1,3,Platinum
1467,14331.0,124,28,462.65999999999997,3,3,3,9,Gold
1468,14332.0,22,25,840.21,2,3,2,7,Diamond
1469,14333.0,64,19,351.45,3,3,3,9,Gold
1470,14334.0,16,163,2539.46,1,1,1,3,Platinum
1471,14335.0,16,60,454.85999999999996,1,2,3,6,Diamond
1472,14336.0,16,90,1614.91,1,2,1,4,Platinum
1473,14338.0,158,34,554.2199999999999,4,3,3,10,Silver
1474,14339.0,234,18,289.91,4,3,4,11,Bronze
1475,14340.0,218,6,134.7,4,4,4,12,Bronze
1476,14341.0,45,129,2151.08,2,1,1,4,Platinum
1477,14342.0,21,24,607.71,2,3,3,8,Gold
1478,14344.0,127,71,889.9300000000002,3,2,2,7,Diamond
1479,14345.0,38,6,108.97999999999999,2,4,4,10,Silver
1480,14346.0,120,60,1021.58,3,2,2,7,Diamond
1481,14348.0,260,18,409.57,4,3,3,10,Silver
1482,14349.0,10,31,133.5,1,3,4,8,Gold
1483,14350.0,270,21,258.7,4,3,4,11,Bronze
1484,14351.0,164,1,51.0,4,4,4,12,Bronze
1485,14352.0,157,47,1078.9600000000003,4,2,2,8,Gold
1486,14353.0,215,6,90.6,4,4,4,12,Bronze
1487,14354.0,5,9,163.62,1,4,4,9,Gold
1488,14355.0,365,11,174.4,4,4,4,12,Bronze
1489,14356.0,60,38,666.9399999999999,3,3,2,8,Gold
1490,14357.0,43,40,225.12,2,3,4,9,Gold
1491,14359.0,19,58,882.5799999999999,2,2,2,6,Diamond
1492,14360.0,31,117,2118.03,2,1,1,4,Platinum
1493,14362.0,22,37,151.50000000000003,2,3,4,9,Gold
1494,14364.0,108,69,3717.35,3,2,1,6,Diamond
1495,14367.0,8,530,9134.119999999999,1,1,1,3,Platinum
1496,14368.0,319,8,155.0,4,4,4,12,Bronze
1497,14371.0,295,4,100.5,4,4,4,12,Bronze
1498,14373.0,358,4,76.55,4,4,4,12,Bronze
1499,14375.0,185,66,235.56,4,2,4,10,Silver
1500,14377.0,191,11,617.05,4,4,3,11,Bronze
1501,14379.0,44,46,348.1,2,2,3,7,Diamond
1502,14381.0,52,56,202.68,3,2,4,9,Gold
1503,14382.0,26,126,615.4899999999999,2,1,3,6,Diamond
1504,14383.0,38,59,1247.69,2,2,2,6,Diamond
1505,14385.0,9,14,202.10999999999999,1,4,4,9,Gold
1506,14386.0,296,7,142.4,4,4,4,12,Bronze
1507,14387.0,32,139,1727.6000000000001,2,1,1,4,Platinum
1508,14388.0,8,191,3172.04,1,1,1,3,Platinum
1509,14389.0,8,62,999.72,1,2,2,5,Platinum
1510,14390.0,10,289,4582.22,1,1,1,3,Platinum
1511,14393.0,218,5,67.94999999999999,4,4,4,12,Bronze
1512,14395.0,2,351,3444.11,1,1,1,3,Platinum
1513,14396.0,65,73,487.99000000000007,3,2,3,8,Gold
1514,14397.0,0,95,2556.68,1,2,1,4,Platinum
1515,14400.0,141,26,559.6999999999999,3,3,3,9,Gold
1516,14401.0,4,183,4039.98,1,1,1,3,Platinum
1517,14403.0,130,26,1426.31,3,3,2,8,Gold
1518,14404.0,33,101,1409.72,2,1,2,5,Platinum
1519,14406.0,119,8,156.75,3,4,4,11,Bronze
1520,14407.0,107,76,2111.08,3,2,1,6,Diamond
1521,14408.0,10,106,2599.03,1,1,1,3,Platinum
1522,14409.0,71,55,1908.2500000000002,3,2,1,6,Diamond
1523,14410.0,15,282,573.45,1,1,3,5,Platinum
1524,14411.0,310,14,1063.0,4,4,2,10,Silver
1525,14412.0,35,45,761.33,2,2,2,6,Diamond
1526,14413.0,362,22,121.05000000000001,4,3,4,11,Bronze
1527,14414.0,91,98,1485.1300000000003,3,2,2,7,Diamond
1528,14415.0,1,601,5766.85,1,1,1,3,Platinum
1529,14416.0,22,14,490.2200000000001,2,4,3,9,Gold
1530,14418.0,3,124,1937.25,1,1,1,3,Platinum
1531,14419.0,10,202,1051.79,1,1,2,4,Platinum
1532,14420.0,85,30,385.87,3,3,3,9,Gold
1533,14421.0,57,27,813.1100000000001,3,3,2,8,Gold
1534,14422.0,0,222,4263.639999999999,1,1,1,3,Platinum
1535,14423.0,218,3,265.2,4,4,4,12,Bronze
1536,14424.0,17,1,322.08,2,4,3,9,Gold
1537,14426.0,18,264,3918.8999999999996,2,1,1,4,Platinum
1538,14427.0,50,17,363.34000000000003,2,4,3,9,Gold
1539,14428.0,7,141,1209.3700000000001,1,1,2,4,Platinum
1540,14431.0,298,21,423.26000000000005,4,3,3,10,Silver
1541,14432.0,9,377,2248.5,1,1,1,3,Platinum
1542,14434.0,21,12,1372.8,2,4,2,8,Gold
1543,14436.0,98,9,89.06,3,4,4,11,Bronze
1544,14437.0,143,6,-43.400000000000006,3,4,4,11,Bronze
1545,14438.0,306,9,131.9,4,4,4,12,Bronze
1546,14439.0,319,32,2661.24,4,3,1,8,Gold
1547,14440.0,8,55,2357.6800000000003,1,2,1,4,Platinum
1548,14441.0,0,59,1545.14,1,2,2,5,Platinum
1549,14442.0,1,68,1544.6200000000001,1,2,2,5,Platinum
1550,14443.0,53,98,1400.88,3,2,2,7,Diamond
1551,14446.0,0,277,1010.35,1,1,2,4,Platinum
1552,14447.0,18,70,1163.2300000000002,2,2,2,6,Diamond
1553,14448.0,9,20,375.35,1,3,3,7,Diamond
1554,14449.0,18,250,885.8000000000001,2,1,2,5,Platinum
1555,14450.0,180,40,483.24999999999994,4,3,3,10,Silver
1556,14451.0,60,105,643.9000000000001,3,1,3,7,Diamond
1557,14452.0,10,60,259.05,1,2,4,7,Diamond
1558,14453.0,190,22,119.93,4,3,4,11,Bronze
1559,14456.0,5,954,3002.51,1,1,1,3,Platinum
1560,14457.0,310,4,113.64,4,4,4,12,Bronze
1561,14459.0,155,37,1837.92,4,3,1,8,Gold
1562,14460.0,110,17,383.34,3,4,3,10,Silver
1563,14461.0,148,180,2103.0599999999995,4,1,1,6,Diamond
1564,14462.0,63,239,1942.45,3,1,1,5,Platinum
1565,14463.0,98,6,529.62,3,4,3,10,Silver
1566,14465.0,246,123,1038.44,4,1,2,7,Diamond
1567,14466.0,29,72,2272.4,2,2,1,5,Platinum
1568,14467.0,17,89,596.2600000000001,2,2,3,7,Diamond
1569,14470.0,11,43,461.19000000000005,1,2,3,6,Diamond
1570,14472.0,103,265,1852.67,3,1,1,5,Platinum
1571,14473.0,74,7,234.34,3,4,4,11,Bronze
1572,14474.0,43,30,537.71,2,3,3,8,Gold
1573,14475.0,71,47,799.8199999999999,3,2,2,7,Diamond
1574,14476.0,257,17,193.0,4,4,4,12,Bronze
1575,14477.0,19,11,1307.8100000000002,2,4,2,8,Gold
1576,14479.0,253,18,316.24999999999994,4,3,3,10,Silver
1577,14480.0,11,13,279.05,1,4,4,9,Gold
1578,14481.0,164,30,636.51,4,3,3,10,Silver
1579,14482.0,18,137,2022.81,2,1,1,4,Platinum
1580,14483.0,149,10,129.2,4,4,4,12,Bronze
1581,14484.0,50,14,321.92,2,4,3,9,Gold
1582,14485.0,38,46,162.8,2,2,4,8,Gold
1583,14487.0,26,141,1152.73,2,1,2,5,Platinum
1584,14488.0,51,49,1047.43,3,2,2,7,Diamond
1585,14489.0,207,30,463.38,4,3,3,10,Silver
1586,14491.0,175,17,340.93,4,4,3,11,Bronze
1587,14493.0,7,123,2362.84,1,1,1,3,Platinum
1588,14494.0,25,7,139.56,2,4,4,10,Silver
1589,14495.0,50,6,123.79999999999998,2,4,4,10,Silver
1590,14496.0,311,19,538.8100000000001,4,3,3,10,Silver
1591,14497.0,301,31,457.47,4,3,3,10,Silver
1592,14498.0,42,193,1957.3200000000002,2,1,1,4,Platinum
1593,14499.0,26,190,808.44,2,1,2,5,Platinum
1594,14500.0,88,7,356.85,3,4,3,10,Silver
1595,14501.0,64,12,190.31000000000003,3,4,4,11,Bronze
1596,14502.0,19,615,2310.1800000000003,2,1,1,4,Platinum
1597,14503.0,3,164,3543.26,1,1,1,3,Platinum
1598,14504.0,47,107,673.26,2,1,2,5,Platinum
1599,14505.0,17,789,5772.49,2,1,1,4,Platinum
1600,14506.0,17,295,1960.6499999999999,2,1,1,4,Platinum
1601,14507.0,23,97,1352.88,2,2,2,6,Diamond
1602,14508.0,22,55,268.05000000000007,2,2,4,8,Gold
1603,14511.0,11,71,1267.4100000000003,1,2,2,5,Platinum
1604,14512.0,187,23,275.28,4,3,4,11,Bronze
1605,14513.0,100,18,438.49,3,3,3,9,Gold
1606,14514.0,61,69,990.2,3,2,2,7,Diamond
1607,14515.0,17,98,2076.8900000000003,2,2,1,5,Platinum
1608,14517.0,33,18,330.45000000000005,2,3,3,8,Gold
1609,14518.0,64,16,174.37,3,4,4,11,Bronze
1610,14520.0,1,4,270.6,1,4,4,9,Gold
1611,14522.0,24,17,974.54,2,4,2,8,Gold
1612,14523.0,108,12,241.09,3,4,4,11,Bronze
1613,14524.0,31,197,1843.83,2,1,1,4,Platinum
1614,14525.0,8,289,4105.07,1,1,1,3,Platinum
1615,14527.0,2,1010,7709.6900000000005,1,1,1,3,Platinum
1616,14528.0,37,18,364.21999999999997,2,3,3,8,Gold
1617,14529.0,60,213,578.6099999999999,3,1,3,7,Diamond
1618,14530.0,25,213,2862.11,2,1,1,4,Platinum
1619,14532.0,236,64,932.8500000000001,4,2,2,8,Gold
1620,14533.0,24,65,1812.6200000000003,2,2,1,5,Platinum
1621,14534.0,2,547,4025.6000000000004,1,1,1,3,Platinum
1622,14535.0,59,331,2831.7400000000002,3,1,1,5,Platinum
1623,14536.0,259,18,170.95,4,3,4,11,Bronze
1624,14537.0,57,10,355.56000000000006,3,4,3,10,Silver
1625,14538.0,64,19,388.24999999999994,3,3,3,9,Gold
1626,14539.0,15,32,537.48,1,3,3,7,Diamond
1627,14540.0,9,71,952.66,1,2,2,5,Platinum
1628,14541.0,58,105,1453.35,3,1,2,6,Diamond
1629,14542.0,185,5,103.25000000000001,4,4,4,12,Bronze
1630,14543.0,3,105,2916.17,1,1,1,3,Platinum
1631,14544.0,24,111,2004.3000000000004,2,1,1,4,Platinum
1632,14546.0,4,415,2482.8599999999997,1,1,1,3,Platinum
1633,14547.0,3,356,3953.9500000000003,1,1,1,3,Platinum
1634,14548.0,150,4,652.8,4,4,2,10,Silver
1635,14549.0,311,56,289.24,4,2,4,10,Silver
1636,14550.0,10,47,757.3700000000001,1,2,2,5,Platinum
1637,14551.0,18,10,186.23000000000002,2,4,4,10,Silver
1638,14552.0,151,57,164.22,4,2,4,10,Silver
1639,14553.0,19,113,859.2700000000001,2,1,2,5,Platinum
1640,14554.0,10,203,2279.4900000000002,1,1,1,3,Platinum
1641,14555.0,57,19,312.54,3,3,3,9,Gold
1642,14557.0,64,32,0.0,3,3,4,10,Silver
1643,14560.0,7,76,2174.1800000000003,1,2,1,4,Platinum
1644,14561.0,75,69,1080.76,3,2,2,7,Diamond
1645,14562.0,3,441,4676.62,1,1,1,3,Platinum
1646,14565.0,95,129,3073.77,3,1,1,5,Platinum
1647,14566.0,110,4,1432.0,3,4,2,9,Gold
1648,14567.0,35,34,1524.46,2,3,2,7,Diamond
1649,14569.0,1,12,227.38999999999996,1,4,4,9,Gold
1650,14570.0,280,29,218.06,4,3,4,11,Bronze
1651,14572.0,3,265,2775.39,1,1,1,3,Platinum
1652,14573.0,179,233,1590.1200000000001,4,1,2,7,Diamond
1653,14576.0,372,1,35.400000000000006,4,4,4,12,Bronze
1654,14577.0,12,123,859.7100000000002,1,1,2,4,Platinum
1655,14578.0,3,24,168.63,1,3,4,8,Gold
1656,14581.0,16,17,138.6,1,4,4,9,Gold
1657,14582.0,40,6,114.11,2,4,4,10,Silver
1658,14583.0,5,302,986.9599999999999,1,1,2,4,Platinum
1659,14584.0,169,99,1020.0600000000001,4,2,2,8,Gold
1660,14585.0,50,29,157.05,2,3,4,9,Gold
1661,14586.0,227,27,134.16000000000003,4,3,4,11,Bronze
1662,14587.0,18,372,1577.3899999999999,2,1,2,5,Platinum
1663,14589.0,371,3,39.75,4,4,4,12,Bronze
1664,14591.0,15,176,1320.21,1,1,2,4,Platinum
1665,14592.0,35,158,557.9399999999999,2,1,3,6,Diamond
1666,14593.0,21,151,617.15,2,1,3,6,Diamond
1667,14594.0,7,52,363.3299999999999,1,2,3,6,Diamond
1668,14595.0,19,102,1740.6000000000001,2,1,1,4,Platinum
1669,14597.0,11,47,866.2400000000001,1,2,2,5,Platinum
1670,14598.0,44,50,221.97,2,2,4,8,Gold
1671,14600.0,305,25,393.33,4,3,3,10,Silver
1672,14601.0,10,7,213.96000000000004,1,4,4,9,Gold
1673,14603.0,274,2,660.0,4,4,2,10,Silver
1674,14606.0,1,2759,11633.350000000002,1,1,1,3,Platinum
1675,14607.0,15,109,10981.1,1,1,1,3,Platinum
1676,14608.0,4,20,1785.1499999999999,1,3,1,5,Platinum
1677,14609.0,72,4,601.5600000000001,3,4,3,10,Silver
1678,14616.0,242,3,406.08000000000004,4,4,3,11,Bronze
1679,14618.0,9,17,538.59,1,4,3,8,Gold
1680,14619.0,239,22,379.50999999999993,4,3,3,10,Silver
1681,14620.0,204,30,393.2800000000001,4,3,3,10,Silver
1682,14621.0,1,96,1765.7599999999998,1,2,1,4,Platinum
1683,14622.0,184,21,320.58,4,3,3,10,Silver
1684,14623.0,32,134,866.8,2,1,2,5,Platinum
1685,14624.0,57,13,225.84999999999997,3,4,4,11,Bronze
1686,14625.0,185,57,848.48,4,2,2,8,Gold
1687,14626.0,8,126,2757.07,1,1,1,3,Platinum
1688,14627.0,311,5,-21.849999999999998,4,4,4,12,Bronze
1689,14628.0,91,24,671.9599999999999,3,3,2,8,Gold
1690,14629.0,4,151,935.46,1,1,2,4,Platinum
1691,14631.0,50,41,1006.98,2,3,2,7,Diamond
1692,14632.0,262,8,114.56,4,4,4,12,Bronze
1693,14633.0,266,20,344.9000000000001,4,3,3,10,Silver
1694,14636.0,36,28,609.8500000000001,2,3,3,8,Gold
1695,14638.0,50,16,443.6,2,4,3,9,Gold
1696,14639.0,52,175,2952.34,3,1,1,5,Platinum
1697,14640.0,15,112,2024.45,1,1,1,3,Platinum
1698,14641.0,21,7,110.46,2,4,4,10,Silver
1699,14642.0,58,2,96.12,3,4,4,11,Bronze
1700,14643.0,170,34,668.6099999999999,4,3,2,9,Gold
1701,14644.0,9,29,780.4599999999999,1,3,2,6,Diamond
1702,14645.0,156,30,597.0899999999999,4,3,3,10,Silver
1703,14646.0,1,2085,279489.02,1,1,1,3,Platinum
1704,14647.0,201,28,236.04,4,3,4,11,Bronze
1705,14649.0,4,186,1402.59,1,1,2,4,Platinum
1706,14651.0,67,101,653.7499999999998,3,1,2,6,Diamond
1707,14652.0,77,29,114.18,3,3,4,10,Silver
1708,14653.0,1,234,1926.6499999999999,1,1,1,3,Platinum
1709,14655.0,3,50,1930.15,1,2,1,4,Platinum
1710,14656.0,169,80,291.05,4,2,4,10,Silver
1711,14657.0,17,127,838.27,2,1,2,5,Platinum
1712,14658.0,5,29,247.14999999999998,1,3,4,8,Gold
1713,14659.0,8,259,2456.5299999999997,1,1,1,3,Platinum
1714,14660.0,86,30,285.73999999999995,3,3,4,10,Silver
1715,14661.0,26,4,107.95,2,4,4,10,Silver
1716,14662.0,28,157,741.3699999999999,2,1,2,5,Platinum
1717,14664.0,19,98,636.24,2,2,3,7,Diamond
1718,14665.0,60,117,1258.38,3,1,2,6,Diamond
1719,14666.0,24,14,195.25,2,4,4,10,Silver
1720,14667.0,10,570,9165.04,1,1,1,3,Platinum
1721,14669.0,241,166,1259.2400000000002,4,1,2,7,Diamond
1722,14670.0,280,123,392.86,4,1,3,8,Gold
1723,14672.0,234,61,765.55,4,2,2,8,Gold
1724,14673.0,3,74,1736.4,1,2,1,4,Platinum
1725,14675.0,16,97,596.36,1,2,3,6,Diamond
1726,14676.0,31,44,2543.24,2,2,1,5,Platinum
1727,14679.0,371,1,-2.55,4,4,4,12,Bronze
1728,14680.0,25,320,26932.339999999997,2,1,1,4,Platinum
1729,14681.0,71,7,498.95,3,4,3,10,Silver
1730,14682.0,187,2,52.0,4,4,4,12,Bronze
1731,14684.0,25,390,1201.5099999999998,2,1,2,5,Platinum
1732,14687.0,106,15,628.3799999999999,3,4,3,10,Silver
1733,14688.0,7,356,5055.610000000001,1,1,1,3,Platinum
1734,14689.0,208,13,112.80000000000001,4,4,4,12,Bronze
1735,14690.0,44,52,341.96,2,2,3,7,Diamond
1736,14691.0,30,71,2114.33,2,2,1,5,Platinum
1737,14692.0,137,69,582.0500000000001,3,2,3,8,Gold
1738,14693.0,264,8,172.9,4,4,4,12,Bronze
1739,14696.0,4,133,2070.9700000000003,1,1,1,3,Platinum
1740,14697.0,218,22,188.60999999999996,4,3,4,11,Bronze
1741,14698.0,1,200,1217.27,1,1,2,4,Platinum
1742,14699.0,214,8,109.13000000000001,4,4,4,12,Bronze
1743,14700.0,32,112,2195.0999999999995,2,1,1,4,Platinum
1744,14701.0,10,342,2462.94,1,1,1,3,Platinum
1745,14702.0,1,343,3210.29,1,1,1,3,Platinum
1746,14703.0,14,22,318.16999999999996,1,3,3,7,Diamond
1747,14704.0,11,393,1493.96,1,1,2,4,Platinum
1748,14705.0,198,1,179.0,4,4,4,12,Bronze
1749,14708.0,2,29,1096.6699999999998,1,3,2,6,Diamond
1750,14709.0,15,197,4911.140000000001,1,1,1,3,Platinum
1751,14710.0,14,136,599.48,1,1,3,5,Platinum
1752,14711.0,10,347,2809.02,1,1,1,3,Platinum
1753,14712.0,29,25,917.07,2,3,2,7,Diamond
1754,14713.0,9,340,2660.0999999999995,1,1,1,3,Platinum
1755,14714.0,24,10,160.19,2,4,4,10,Silver
1756,14715.0,24,71,867.3800000000001,2,2,2,6,Diamond
1757,14716.0,43,51,307.50999999999993,2,2,3,7,Diamond
1758,14719.0,1,236,1571.89,1,1,2,4,Platinum
1759,14720.0,5,37,663.8100000000002,1,3,2,6,Diamond
1760,14722.0,147,28,180.42,4,3,4,11,Bronze
1761,14723.0,10,259,1122.3600000000001,1,1,2,4,Platinum
1762,14725.0,24,47,655.5800000000002,2,2,2,6,Diamond
1763,14727.0,274,10,268.58,4,4,4,12,Bronze
1764,14729.0,373,71,313.49000000000007,4,2,3,9,Gold
1765,14730.0,1,462,1897.5700000000002,1,1,1,3,Platinum
1766,14731.0,47,45,380.02000000000004,2,2,3,7,Diamond
1767,14732.0,8,149,2686.34,1,1,1,3,Platinum
1768,14733.0,9,216,9451.54,1,1,1,3,Platinum
1769,14735.0,3,205,5807.6900000000005,1,1,1,3,Platinum
1770,14737.0,3,17,1164.55,1,4,2,7,Diamond
1771,14738.0,39,56,1289.94,2,2,2,6,Diamond
1772,14739.0,2,61,3899.1,1,2,1,4,Platinum
1773,14740.0,191,93,1423.2099999999996,4,2,2,8,Gold
1774,14741.0,11,59,1400.3400000000001,1,2,2,5,Platinum
1775,14744.0,16,28,1088.53,1,3,2,6,Diamond
1776,14745.0,112,70,1167.1600000000003,3,2,2,7,Diamond
1777,14747.0,247,19,294.29999999999995,4,3,3,10,Silver
1778,14748.0,29,92,1311.79,2,2,2,6,Diamond
1779,14752.0,43,5,389.63999999999993,2,4,3,9,Gold
1780,14753.0,87,30,563.1499999999999,3,3,3,9,Gold
1781,14754.0,44,41,638.05,2,3,3,8,Gold
1782,14755.0,9,237,4965.38,1,1,1,3,Platinum
1783,14756.0,15,38,738.9599999999998,1,3,2,6,Diamond
1784,14757.0,75,19,420.50000000000006,3,3,3,9,Gold
1785,14758.0,144,71,1484.06,4,2,2,8,Gold
1786,14759.0,4,102,1625.97,1,1,1,3,Platinum
1787,14760.0,294,7,53.8,4,4,4,12,Bronze
1788,14761.0,58,11,255.89999999999998,3,4,4,11,Bronze
1789,14762.0,263,21,300.52,4,3,3,10,Silver
1790,14764.0,43,7,250.55,2,4,4,10,Silver
1791,14765.0,29,39,254.11,2,3,4,9,Gold
1792,14766.0,8,137,2423.0699999999997,1,1,1,3,Platinum
1793,14768.0,17,6,139.50000000000003,2,4,4,10,Silver
1794,14769.0,2,1066,10383.829999999998,1,1,1,3,Platinum
1795,14770.0,232,52,876.42,4,2,2,8,Gold
1796,14772.0,112,9,139.26,3,4,4,11,Bronze
1797,14775.0,58,60,1011.8999999999999,3,2,2,7,Diamond
1798,14776.0,51,134,2195.5800000000004,3,1,1,5,Platinum
1799,14777.0,4,3,-17.45,1,4,4,9,Gold
1800,14778.0,127,35,730.8599999999999,3,3,2,8,Gold
1801,14779.0,280,41,386.15,4,3,3,10,Silver
1802,14780.0,54,27,447.68,3,3,3,9,Gold
1803,14782.0,319,6,200.10000000000002,4,4,4,12,Bronze
1804,14784.0,26,15,289.99,2,4,4,10,Silver
1805,14785.0,10,3,77.4,1,4,4,9,Gold
1806,14788.0,7,30,679.4399999999998,1,3,2,6,Diamond
1807,14789.0,28,6,197.64000000000001,2,4,4,10,Silver
1808,14790.0,16,46,745.0600000000001,1,2,2,5,Platinum
1809,14792.0,63,4,0.0,3,4,4,11,Bronze
1810,14793.0,4,15,214.14000000000001,1,4,4,9,Gold
1811,14794.0,2,82,1272.11,1,2,2,5,Platinum
1812,14795.0,166,6,131.45,4,4,4,12,Bronze
1813,14796.0,1,1156,7792.51,1,1,1,3,Platinum
1814,14798.0,52,12,173.74,3,4,4,11,Bronze
1815,14799.0,51,13,157.70000000000002,3,4,4,11,Bronze
1816,14800.0,47,390,4228.389999999999,2,1,1,4,Platinum
1817,14801.0,61,57,189.34,3,2,4,9,Gold
1818,14803.0,162,44,845.55,4,2,2,8,Gold
1819,14804.0,8,12,353.27,1,4,3,8,Gold
1820,14805.0,15,46,546.4000000000001,1,2,3,6,Diamond
1821,14806.0,75,11,193.39,3,4,4,11,Bronze
1822,14808.0,39,252,2152.8,2,1,1,4,Platinum
1823,14810.0,40,254,2085.33,2,1,1,4,Platinum
1824,14813.0,369,29,152.87999999999997,4,3,4,11,Bronze
1825,14815.0,36,53,778.5,2,2,2,6,Diamond
1826,14816.0,197,4,271.85,4,4,4,12,Bronze
1827,14817.0,200,63,1110.3400000000001,4,2,2,8,Gold
1828,14818.0,73,48,657.8,3,2,2,7,Diamond
1829,14819.0,64,13,272.07,3,4,4,11,Bronze
1830,14820.0,21,29,507.28999999999996,2,3,3,8,Gold
1831,14821.0,366,2,48.800000000000004,4,4,4,12,Bronze
1832,14823.0,180,70,321.42999999999995,4,2,3,9,Gold
1833,14824.0,10,29,1127.7100000000003,1,3,2,6,Diamond
1834,14825.0,3,120,2221.0100000000007,1,1,1,3,Platinum
1835,14828.0,196,17,2139.76,4,4,1,9,Gold
1836,14829.0,29,45,644.65,2,2,2,6,Diamond
1837,14830.0,53,39,188.88,3,3,4,10,Silver
1838,14834.0,17,70,1698.3500000000001,2,2,1,5,Platinum
1839,14836.0,10,6,102.44999999999999,1,4,4,9,Gold
1840,14837.0,89,110,1641.2000000000005,3,1,1,5,Platinum
1841,14840.0,267,4,62.85,4,4,4,12,Bronze
1842,14841.0,53,138,3295.7599999999998,3,1,1,5,Platinum
1843,14842.0,35,158,2456.8,2,1,1,4,Platinum
1844,14844.0,63,130,3189.8100000000004,3,1,1,5,Platinum
1845,14847.0,148,13,309.4,4,4,3,11,Bronze
1846,14849.0,21,392,7904.280000000001,2,1,1,4,Platinum
1847,14850.0,311,22,278.15000000000003,4,3,4,11,Bronze
1848,14851.0,23,28,511.3499999999999,2,3,3,8,Gold
1849,14852.0,58,143,2836.69,3,1,1,5,Platinum
1850,14853.0,8,10,463.04999999999995,1,4,3,8,Gold
1851,14854.0,78,130,2730.09,3,1,1,5,Platinum
1852,14855.0,119,20,645.65,3,3,2,8,Gold
1853,14856.0,36,65,1290.53,2,2,2,6,Diamond
1854,14857.0,59,61,1165.65,3,2,2,7,Diamond
1855,14859.0,12,59,1352.0400000000002,1,2,2,5,Platinum
1856,14860.0,8,12,168.62,1,4,4,9,Gold
1857,14861.0,52,6,125.79000000000002,3,4,4,11,Bronze
1858,14862.0,25,48,841.2,2,2,2,6,Diamond
1859,14863.0,29,11,266.76,2,4,4,10,Silver
1860,14865.0,7,4,52.2,1,4,4,9,Gold
1861,14866.0,10,103,14197.45,1,1,1,3,Platinum
1862,14867.0,185,37,701.33,4,3,2,9,Gold
1863,14868.0,3,147,2939.6400000000003,1,1,1,3,Platinum
1864,14869.0,3,71,717.7,1,2,2,5,Platinum
1865,14870.0,261,13,327.24999999999994,4,4,3,11,Bronze
1866,14871.0,3,93,501.28,1,2,3,6,Diamond
1867,14873.0,210,28,519.6800000000001,4,3,3,10,Silver
1868,14875.0,9,50,1448.72,1,2,2,5,Platinum
1869,14878.0,12,122,1476.0900000000001,1,1,2,4,Platinum
1870,14880.0,77,46,690.59,3,2,2,7,Diamond
1871,14881.0,19,17,255.4,2,4,4,10,Silver
1872,14882.0,26,11,589.7,2,4,3,9,Gold
1873,14883.0,18,54,756.6400000000001,2,2,2,6,Diamond
1874,14885.0,131,15,765.3199999999999,3,4,2,9,Gold
1875,14886.0,252,18,364.79999999999995,4,3,3,10,Silver
1876,14887.0,79,6,1862.0,3,4,1,8,Gold
1877,14888.0,207,20,369.2,4,3,3,10,Silver
1878,14889.0,336,10,135.9,4,4,4,12,Bronze
1879,14890.0,253,7,125.65,4,4,4,12,Bronze
1880,14891.0,148,33,554.38,4,3,3,10,Silver
1881,14893.0,9,73,1237.8500000000001,1,2,2,5,Platinum
1882,14894.0,85,23,655.7499999999999,3,3,2,8,Gold
1883,14895.0,7,506,11020.26,1,1,1,3,Platinum
1884,14896.0,204,43,468.77000000000004,4,2,3,9,Gold
1885,14897.0,7,55,1366.38,1,2,2,5,Platinum
1886,14898.0,23,112,1194.1100000000001,2,1,2,5,Platinum
1887,14901.0,11,98,1414.99,1,2,2,5,Platinum
1888,14902.0,21,24,314.11,2,3,3,8,Gold
1889,14903.0,21,359,2729.1800000000003,2,1,1,4,Platinum
1890,14904.0,2,69,1025.44,1,2,2,5,Platinum
1891,14905.0,154,18,599.9,4,3,3,10,Silver
1892,14907.0,3,168,3478.85,1,1,1,3,Platinum
1893,14908.0,74,9,277.79999999999995,3,4,4,11,Bronze
1894,14910.0,2,35,389.86,1,3,3,7,Diamond
1895,14911.0,1,5898,132458.72999999998,1,1,1,3,Platinum
1896,14912.0,16,28,841.52,1,3,2,6,Diamond
1897,14913.0,35,87,1227.43,2,2,2,6,Diamond
1898,14915.0,85,13,258.83000000000004,3,4,4,11,Bronze
1899,14916.0,70,79,1264.8400000000001,3,2,2,7,Diamond
1900,14918.0,115,45,1610.1499999999996,3,2,1,6,Diamond
1901,14920.0,212,57,977.77,4,2,2,8,Gold
1902,14921.0,30,78,1316.0700000000002,2,2,2,6,Diamond
1903,14923.0,50,44,749.1,2,2,2,6,Diamond
1904,14924.0,245,10,310.05,4,4,3,11,Bronze
1905,14929.0,32,11,223.88,2,4,4,10,Silver
1906,14930.0,108,127,2362.9600000000005,3,1,1,5,Platinum
1907,14931.0,4,42,964.6800000000001,1,2,2,5,Platinum
1908,14932.0,365,17,363.53,4,4,3,11,Bronze
1909,14934.0,72,88,1888.84,3,2,1,6,Diamond
1910,14935.0,297,10,1784.71,4,4,1,9,Gold
1911,14936.0,9,366,8117.420000000002,1,1,1,3,Platinum
1912,14937.0,56,35,1617.6299999999999,3,3,1,7,Diamond
1913,14944.0,29,172,5842.950000000001,2,1,1,4,Platinum
1914,14946.0,14,3,100.9,1,4,4,9,Gold
1915,14947.0,72,14,290.82000000000005,3,4,4,11,Bronze
1916,14948.0,23,64,1066.5700000000002,2,2,2,6,Diamond
1917,14950.0,8,20,361.25,1,3,3,7,Diamond
1918,14951.0,79,20,311.69000000000005,3,3,3,9,Gold
1919,14952.0,46,149,7912.790000000001,2,1,1,4,Platinum
1920,14953.0,25,54,285.67,2,2,4,8,Gold
1921,14954.0,12,77,294.84999999999997,1,2,3,6,Diamond
1922,14957.0,253,12,58.49,4,4,4,12,Bronze
1923,14958.0,147,41,483.73,4,3,3,10,Silver
1924,14959.0,59,61,684.9699999999998,3,2,2,7,Diamond
1925,14960.0,8,27,221.26999999999998,1,3,4,8,Gold
1926,14961.0,10,317,7006.58,1,1,1,3,Platinum
1927,14962.0,270,5,126.70000000000002,4,4,4,12,Bronze
1928,14963.0,9,192,1472.34,1,1,2,4,Platinum
1929,14964.0,247,13,206.21,4,4,4,12,Bronze
1930,14965.0,96,81,596.09,3,2,3,8,Gold
1931,14966.0,14,36,183.01999999999998,1,3,4,8,Gold
1932,14967.0,49,6,463.8,2,4,3,9,Gold
1933,14968.0,30,37,147.59000000000003,2,3,4,9,Gold
1934,14970.0,68,34,1592.06,3,3,2,8,Gold
1935,14971.0,35,155,1097.98,2,1,2,5,Platinum
1936,14972.0,128,18,114.77,3,3,4,10,Silver
1937,14973.0,107,32,1314.4499999999998,3,3,2,8,Gold
1938,14974.0,37,17,89.94,2,4,4,10,Silver
1939,14975.0,57,11,279.94,3,4,4,11,Bronze
1940,14976.0,57,73,765.86,3,2,2,7,Diamond
1941,14978.0,72,214,1921.3700000000003,3,1,1,5,Platinum
1942,14981.0,246,8,102.12,4,4,4,12,Bronze
1943,14984.0,19,39,202.37,2,3,4,9,Gold
1944,14985.0,198,83,292.01,4,2,3,9,Gold
1945,14987.0,15,4,326.4,1,4,3,8,Gold
1946,14988.0,211,40,334.53999999999996,4,3,3,10,Silver
1947,14995.0,38,60,231.98000000000002,2,2,4,8,Gold
1948,14997.0,46,27,540.98,2,3,3,8,Gold
1949,14998.0,170,74,414.87,4,2,3,9,Gold
1950,15000.0,47,77,490.52000000000004,2,2,3,7,Diamond
1951,15002.0,115,115,1641.7599999999998,3,1,1,5,Platinum
1952,15004.0,147,154,1220.77,4,1,2,7,Diamond
1953,15005.0,15,1152,6160.54,1,1,1,3,Platinum
1954,15006.0,51,132,480.38000000000005,3,1,3,7,Diamond
1955,15007.0,159,12,156.91000000000003,4,4,4,12,Bronze
1956,15009.0,12,180,1259.4299999999998,1,1,2,4,Platinum
1957,15010.0,35,20,308.94,2,3,3,8,Gold
1958,15012.0,53,122,405.04,3,1,3,7,Diamond
1959,15014.0,43,33,257.66999999999996,2,3,4,9,Gold
1960,15016.0,172,20,170.04,4,3,4,11,Bronze
1961,15017.0,33,20,125.58000000000001,2,3,4,9,Gold
1962,15018.0,38,32,456.26,2,3,3,8,Gold
1963,15019.0,266,66,252.81,4,2,4,10,Silver
1964,15021.0,8,451,1829.23,1,1,1,3,Platinum
1965,15022.0,11,121,852.39,1,1,2,4,Platinum
1966,15023.0,3,554,6680.810000000001,1,1,1,3,Platinum
1967,15024.0,9,152,1636.4299999999998,1,1,1,3,Platinum
1968,15025.0,33,67,361.96,2,2,3,7,Diamond
1969,15026.0,80,61,469.0,3,2,3,8,Gold
1970,15027.0,30,37,1051.95,2,3,2,7,Diamond
1971,15028.0,8,48,627.1300000000001,1,2,3,6,Diamond
1972,15030.0,71,7,518.28,3,4,3,10,Silver
1973,15031.0,4,110,653.19,1,1,2,4,Platinum
1974,15032.0,256,55,4464.1,4,2,1,7,Diamond
1975,15033.0,4,504,2541.5299999999997,1,1,1,3,Platinum
1976,15034.0,15,396,4243.210000000001,1,1,1,3,Platinum
1977,15035.0,89,27,252.73000000000002,3,3,4,10,Silver
1978,15036.0,72,119,429.56,3,1,3,7,Diamond
1979,15038.0,43,128,645.8400000000001,2,1,2,5,Platinum
1980,15039.0,9,1483,19638.590000000004,1,1,1,3,Platinum
1981,15041.0,170,66,179.92999999999998,4,2,4,10,Silver
1982,15042.0,199,5,135.93,4,4,4,12,Bronze
1983,15043.0,31,3,537.0,2,4,3,9,Gold
1984,15044.0,19,452,7563.880000000001,2,1,1,4,Platinum
1985,15045.0,151,13,633.66,4,4,3,11,Bronze
1986,15046.0,9,202,4940.66,1,1,1,3,Platinum
1987,15047.0,269,22,343.61999999999995,4,3,3,10,Silver
1988,15048.0,65,95,377.52,3,2,3,8,Gold
1989,15049.0,273,3,121.17000000000002,4,4,4,12,Bronze
1990,15050.0,25,78,1682.7699999999998,2,2,1,5,Platinum
1991,15051.0,23,142,1383.3600000000001,2,1,2,5,Platinum
1992,15052.0,319,28,207.73000000000002,4,3,4,11,Bronze
1993,15053.0,4,69,693.9499999999999,1,2,2,5,Platinum
1994,15054.0,12,114,302.1,1,1,3,5,Platinum
1995,15057.0,275,25,1489.5,4,3,2,9,Gold
1996,15058.0,25,266,2102.54,2,1,1,4,Platinum
1997,15059.0,40,239,1325.82,2,1,2,5,Platinum
1998,15060.0,8,115,294.25000000000006,1,1,3,5,Platinum
1999,15061.0,3,410,54228.740000000005,1,1,1,3,Platinum
2000,15062.0,71,57,987.86,3,2,2,7,Diamond
2001,15063.0,213,5,370.79999999999995,4,4,3,11,Bronze
2002,15065.0,37,158,3135.98,2,1,1,4,Platinum
2003,15066.0,31,53,760.59,2,2,2,6,Diamond
2004,15067.0,78,82,1744.76,3,2,1,6,Diamond
2005,15068.0,46,104,553.36,2,1,3,6,Diamond
2006,15069.0,179,70,1109.5300000000002,4,2,2,8,Gold
2007,15070.0,372,1,106.2,4,4,4,12,Bronze
2008,15071.0,93,26,982.07,3,3,2,8,Gold
2009,15073.0,9,76,612.4300000000001,1,2,3,6,Diamond
2010,15074.0,105,41,735.6700000000001,3,3,2,8,Gold
2011,15075.0,77,27,773.03,3,3,2,8,Gold
2012,15076.0,172,49,880.8499999999999,4,2,2,8,Gold
2013,15078.0,7,451,9623.35,1,1,1,3,Platinum
2014,15079.0,212,48,893.6600000000001,4,2,2,8,Gold
2015,15081.0,22,35,487.34999999999997,2,3,3,8,Gold
2016,15083.0,256,5,88.19999999999999,4,4,4,12,Bronze
2017,15087.0,281,15,306.94,4,4,3,11,Bronze
2018,15088.0,21,60,1140.27,2,2,2,6,Diamond
2019,15089.0,10,145,2420.84,1,1,1,3,Platinum
2020,15090.0,308,23,381.32,4,3,3,10,Silver
2021,15091.0,53,31,476.96,3,3,3,9,Gold
2022,15092.0,215,26,457.80999999999995,4,3,3,10,Silver
2023,15093.0,18,112,4410.14,2,1,1,4,Platinum
2024,15095.0,103,49,1364.6999999999998,3,2,2,7,Diamond
2025,15096.0,42,11,219.39,2,4,4,10,Silver
2026,15097.0,4,25,248.07999999999998,1,3,4,8,Gold
2027,15098.0,182,5,649.5,4,4,2,10,Silver
2028,15099.0,84,23,410.48,3,3,3,9,Gold
2029,15100.0,330,6,635.1,4,4,3,11,Bronze
2030,15101.0,8,9,310.03,1,4,3,8,Gold
2031,15103.0,31,35,703.3599999999999,2,3,2,7,Diamond
2032,15104.0,166,69,968.64,4,2,2,8,Gold
2033,15105.0,18,101,2298.9300000000003,2,1,1,4,Platinum
2034,15106.0,17,102,1407.73,2,1,2,5,Platinum
2035,15107.0,311,20,247.65999999999997,4,3,4,11,Bronze
2036,15108.0,141,61,1291.75,3,2,2,7,Diamond
2037,15109.0,240,31,463.7500000000001,4,3,3,10,Silver
2038,15110.0,23,39,973.1999999999999,2,3,2,7,Diamond
2039,15111.0,29,84,1567.4799999999998,2,2,2,6,Diamond
2040,15113.0,9,98,3339.5099999999998,1,2,1,4,Platinum
2041,15114.0,30,197,2760.5599999999995,2,1,1,4,Platinum
2042,15115.0,18,21,340.11,2,3,3,8,Gold
2043,15116.0,17,45,1352.75,2,2,2,6,Diamond
2044,15117.0,14,80,1550.13,1,2,2,5,Platinum
2045,15118.0,134,1,244.8,3,4,4,11,Bronze
2046,15119.0,245,14,266.4,4,4,4,12,Bronze
2047,15120.0,129,22,343.8199999999999,3,3,3,9,Gold
2048,15121.0,50,28,457.72,2,3,3,8,Gold
2049,15122.0,85,87,1612.1299999999999,3,2,1,6,Diamond
2050,15123.0,7,106,2199.3100000000004,1,1,1,3,Platinum
2051,15124.0,22,15,184.19000000000003,2,4,4,10,Silver
2052,15125.0,25,140,11117.05,2,1,1,4,Platinum
2053,15127.0,65,16,406.53000000000003,3,4,3,10,Silver
2054,15128.0,60,111,1419.54,3,1,2,6,Diamond
2055,15129.0,50,84,3447.4,2,2,1,5,Platinum
2056,15130.0,169,22,330.11000000000007,4,3,3,10,Silver
2057,15132.0,18,52,977.93,2,2,2,6,Diamond
2058,15133.0,127,29,982.4199999999998,3,3,2,8,Gold
2059,15134.0,14,73,1387.99,1,2,2,5,Platinum
2060,15135.0,233,10,127.14999999999998,4,4,4,12,Bronze
2061,15136.0,2,69,1282.45,1,2,2,5,Platinum
2062,15139.0,239,13,178.96,4,4,4,12,Bronze
2063,15140.0,52,81,2350.0,3,2,1,6,Diamond
2064,15142.0,46,26,498.74000000000007,2,3,3,8,Gold
2065,15143.0,225,14,259.45,4,4,4,12,Bronze
2066,15144.0,8,218,6530.040000000001,1,1,1,3,Platinum
2067,15145.0,4,67,1194.7300000000002,1,2,2,5,Platinum
2068,15146.0,164,95,1313.66,4,2,2,8,Gold
2069,15147.0,218,29,608.65,4,3,3,10,Silver
2070,15148.0,10,20,301.29,1,3,3,7,Diamond
2071,15149.0,133,23,520.8,3,3,3,9,Gold
2072,15150.0,17,342,5280.83,2,1,1,4,Platinum
2073,15152.0,9,278,4684.24,1,1,1,3,Platinum
2074,15153.0,31,22,329.25,2,3,3,8,Gold
2075,15154.0,74,75,224.73000000000002,3,2,4,9,Gold
2076,15156.0,1,55,961.4899999999999,1,2,2,5,Platinum
2077,15157.0,3,133,1869.4999999999998,1,1,1,3,Platinum
2078,15158.0,45,7,401.4000000000001,2,4,3,9,Gold
2079,15159.0,1,720,18573.68,1,1,1,3,Platinum
2080,15160.0,357,4,158.16000000000003,4,4,4,12,Bronze
2081,15163.0,18,29,304.4699999999999,2,3,3,8,Gold
2082,15164.0,68,101,824.58,3,1,2,6,Diamond
2083,15165.0,373,27,487.75,4,3,3,10,Silver
2084,15167.0,320,39,158.79999999999998,4,3,4,11,Bronze
2085,15168.0,25,5,106.56,2,4,4,10,Silver
2086,15171.0,324,7,1034.5,4,4,2,10,Silver
2087,15172.0,8,110,1624.05,1,1,1,3,Platinum
2088,15174.0,322,11,135.75,4,4,4,12,Bronze
2089,15175.0,71,23,224.14000000000004,3,3,4,10,Silver
2090,15178.0,260,3,40.5,4,4,4,12,Bronze
2091,15179.0,18,95,2186.2000000000007,2,2,1,5,Platinum
2092,15180.0,367,6,87.5,4,4,4,12,Bronze
2093,15181.0,66,18,680.28,3,3,2,8,Gold
2094,15182.0,154,29,622.8499999999998,4,3,3,10,Silver
2095,15184.0,29,62,402.2,2,2,3,7,Diamond
2096,15185.0,70,21,310.62,3,3,3,9,Gold
2097,15186.0,14,19,411.41,1,3,3,7,Diamond
2098,15187.0,1,93,4670.080000000001,1,2,1,4,Platinum
2099,15189.0,1,232,15802.140000000001,1,1,1,3,Platinum
2100,15192.0,119,51,1044.3200000000002,3,2,2,7,Diamond
2101,15193.0,60,19,499.31999999999994,3,3,3,9,Gold
2102,15194.0,3,326,7521.17,1,1,1,3,Platinum
2103,15195.0,2,1,3861.0,1,4,1,6,Diamond
2104,15197.0,8,36,656.44,1,3,2,6,Diamond
2105,15198.0,92,10,193.64,3,4,4,11,Bronze
2106,15199.0,59,13,1268.6999999999998,3,4,2,9,Gold
2107,15201.0,78,97,927.8400000000001,3,2,2,7,Diamond
2108,15203.0,25,142,1827.8,2,1,1,4,Platinum
2109,15204.0,357,9,316.58,4,4,3,11,Bronze
2110,15205.0,85,38,648.8299999999999,3,3,2,8,Gold
2111,15206.0,10,9,420.3,1,4,3,8,Gold
2112,15208.0,1,43,867.62,1,2,2,5,Platinum
2113,15210.0,225,20,331.18,4,3,3,10,Silver
2114,15211.0,60,52,894.41,3,2,2,7,Diamond
2115,15212.0,239,7,88.94999999999997,4,4,4,12,Bronze
2116,15213.0,318,25,325.05,4,3,3,10,Silver
2117,15214.0,1,110,1661.44,1,1,1,3,Platinum
2118,15215.0,44,43,615.9899999999999,2,2,3,7,Diamond
2119,15216.0,87,2,96.6,3,4,4,11,Bronze
2120,15218.0,10,166,5756.89,1,1,1,3,Platinum
2121,15219.0,176,9,305.75,4,4,3,11,Bronze
2122,15220.0,51,119,1758.9199999999998,3,1,1,5,Platinum
2123,15221.0,366,11,114.10000000000004,4,4,4,12,Bronze
2124,15222.0,318,5,585.0,4,4,3,11,Bronze
2125,15223.0,225,32,454.8999999999999,4,3,3,10,Silver
2126,15224.0,358,16,310.47999999999996,4,4,3,11,Bronze
2127,15225.0,234,23,409.4000000000001,4,3,3,10,Silver
2128,15226.0,310,8,154.41,4,4,4,12,Bronze
2129,15227.0,36,58,1219.4,2,2,2,6,Diamond
2130,15228.0,66,126,3376.9599999999996,3,1,1,5,Platinum
2131,15230.0,239,23,429.6,4,3,3,10,Silver
2132,15232.0,113,31,612.0600000000001,3,3,3,9,Gold
2133,15234.0,276,14,197.00000000000006,4,4,4,12,Bronze
2134,15235.0,217,143,2247.51,4,1,1,6,Diamond
2135,15236.0,298,15,321.04999999999995,4,4,3,11,Bronze
2136,15237.0,1,99,1412.3200000000002,1,2,2,5,Platinum
2137,15238.0,29,52,1056.54,2,2,2,6,Diamond
2138,15239.0,10,52,764.34,1,2,2,5,Platinum
2139,15240.0,44,83,1685.5700000000002,2,2,1,5,Platinum
2140,15241.0,66,111,1738.5900000000001,3,1,1,5,Platinum
2141,15243.0,74,22,316.68,3,3,3,9,Gold
2142,15244.0,65,34,631.5699999999999,3,3,3,9,Gold
2143,15245.0,134,89,2515.84,3,2,1,6,Diamond
2144,15246.0,238,33,514.15,4,3,3,10,Silver
2145,15247.0,122,6,356.0,3,4,3,10,Silver
2146,15249.0,31,358,6657.36,2,1,1,4,Platinum
2147,15251.0,9,121,10327.109999999999,1,1,1,3,Platinum
2148,15252.0,36,44,740.78,2,2,2,6,Diamond
2149,15253.0,16,55,915.3,1,2,2,5,Platinum
2150,15254.0,127,18,300.36000000000007,3,3,3,9,Gold
2151,15255.0,66,47,890.85,3,2,2,7,Diamond
2152,15256.0,148,6,98.45,4,4,4,12,Bronze
2153,15257.0,281,8,232.14999999999998,4,4,4,12,Bronze
2154,15258.0,168,34,623.1600000000001,4,3,3,10,Silver
2155,15260.0,100,78,1780.7699999999998,3,2,1,6,Diamond
2156,15261.0,135,19,254.81999999999996,3,3,4,10,Silver
2157,15262.0,323,10,178.95000000000002,4,4,4,12,Bronze
2158,15263.0,106,12,156.50999999999996,3,4,4,11,Bronze
2159,15264.0,64,23,393.7400000000001,3,3,3,9,Gold
2160,15265.0,151,82,1506.12,4,2,2,8,Gold
2161,15266.0,338,6,119.30000000000001,4,4,4,12,Bronze
2162,15267.0,22,11,1717.36,2,4,1,7,Diamond
2163,15269.0,23,2,408.8,2,4,3,9,Gold
2164,15270.0,15,48,2298.2,1,2,1,4,Platinum
2165,15271.0,7,265,2472.09,1,1,1,3,Platinum
2166,15272.0,57,63,721.94,3,2,2,7,Diamond
2167,15274.0,4,47,716.57,1,2,2,5,Platinum
2168,15275.0,31,42,609.1899999999999,2,2,3,7,Diamond
2169,15276.0,66,49,128.63,3,2,4,9,Gold
2170,15277.0,46,12,255.89999999999998,2,4,4,10,Silver
2171,15279.0,354,21,277.40999999999997,4,3,4,11,Bronze
2172,15280.0,172,16,113.12,4,4,4,12,Bronze
2173,15281.0,58,150,2239.95,3,1,1,5,Platinum
2174,15286.0,49,3,240.55,2,4,4,10,Silver
2175,15287.0,22,21,485.24,2,3,3,8,Gold
2176,15288.0,43,88,2306.5200000000004,2,2,1,5,Platinum
2177,15289.0,29,59,935.1,2,2,2,6,Diamond
2178,15290.0,4,212,7803.7699999999995,1,1,1,3,Platinum
2179,15291.0,25,109,4596.51,2,1,1,4,Platinum
2180,15292.0,201,24,178.39,4,3,4,11,Bronze
2181,15296.0,44,200,3610.31,2,1,1,4,Platinum
2182,15297.0,10,41,635.0400000000001,1,3,3,7,Diamond
2183,15298.0,2,194,3774.1000000000004,1,1,1,3,Platinum
2184,15299.0,67,12,3787.09,3,4,1,8,Gold
2185,15300.0,64,28,496.43999999999994,3,3,3,9,Gold
2186,15301.0,50,246,5007.719999999999,2,1,1,4,Platinum
2187,15303.0,290,31,574.02,4,3,3,10,Silver
2188,15304.0,60,26,680.3000000000002,3,3,2,8,Gold
2189,15306.0,64,58,1174.35,3,2,2,7,Diamond
2190,15307.0,95,12,205.3,3,4,4,11,Bronze
2191,15308.0,270,21,302.27,4,3,3,10,Silver
2192,15311.0,0,2478,59284.19,1,1,1,3,Platinum
2193,15312.0,75,48,921.1,3,2,2,7,Diamond
2194,15313.0,110,1,52.0,3,4,4,11,Bronze
2195,15314.0,199,24,327.96999999999997,4,3,3,10,Silver
2196,15315.0,64,38,551.54,3,3,3,9,Gold
2197,15316.0,326,1,165.0,4,4,4,12,Bronze
2198,15318.0,3,33,312.62,1,3,3,7,Diamond
2199,15319.0,283,16,204.5,4,4,4,12,Bronze
2200,15320.0,44,36,267.13000000000005,2,3,4,9,Gold
2201,15321.0,49,105,2663.48,2,1,1,4,Platinum
2202,15322.0,64,49,602.97,3,2,3,8,Gold
2203,15325.0,103,48,161.74,3,2,4,9,Gold
2204,15326.0,333,29,311.7099999999999,4,3,3,10,Silver
2205,15327.0,52,10,208.75,3,4,4,11,Bronze
2206,15329.0,35,62,1005.5,2,2,2,6,Diamond
2207,15330.0,32,13,714.9599999999999,2,4,2,8,Gold
2208,15332.0,366,35,1661.06,4,3,1,8,Gold
2209,15333.0,208,16,1028.56,4,4,2,10,Silver
2210,15334.0,156,98,350.82,4,2,3,9,Gold
2211,15335.0,53,35,170.22,3,3,4,10,Silver
2212,15339.0,66,88,557.5699999999999,3,2,3,8,Gold
2213,15341.0,80,17,2020.52,3,4,1,8,Gold
2214,15342.0,116,26,391.76,3,3,3,9,Gold
2215,15343.0,87,21,364.5,3,3,3,9,Gold
2216,15344.0,0,32,476.58000000000004,1,3,3,7,Diamond
2217,15345.0,35,23,367.69,2,3,3,8,Gold
2218,15346.0,332,17,252.42000000000002,4,4,4,12,Bronze
2219,15347.0,366,5,201.59999999999997,4,4,4,12,Bronze
2220,15348.0,72,9,158.04,3,4,4,11,Bronze
2221,15349.0,158,71,463.9099999999999,4,2,3,9,Gold
2222,15350.0,373,5,115.65,4,4,4,12,Bronze
2223,15351.0,12,227,1836.69,1,1,1,3,Platinum
2224,15353.0,254,61,770.1200000000001,4,2,2,8,Gold
2225,15355.0,29,14,277.05000000000007,2,4,4,10,Silver
2226,15356.0,31,499,2718.0300000000007,2,1,1,4,Platinum
2227,15358.0,4,560,8235.650000000001,1,1,1,3,Platinum
2228,15360.0,39,13,427.92999999999995,2,4,3,9,Gold
2229,15361.0,361,7,418.9200000000001,4,4,3,11,Bronze
2230,15363.0,241,17,318.05,4,4,3,11,Bronze
2231,15364.0,95,29,913.1900000000002,3,3,2,8,Gold
2232,15365.0,25,151,1330.4500000000003,2,1,2,5,Platinum
2233,15366.0,75,44,602.5100000000001,3,2,3,8,Gold
2234,15367.0,57,96,1867.69,3,2,1,6,Diamond
2235,15368.0,21,4,446.94000000000005,2,4,3,9,Gold
2236,15369.0,144,1,-1592.49,4,4,4,12,Bronze
2237,15370.0,40,95,2360.55,2,2,1,5,Platinum
2238,15372.0,137,27,2007.4,3,3,1,7,Diamond
2239,15373.0,8,137,2213.1099999999997,1,1,1,3,Platinum
2240,15374.0,128,3,168.0,3,4,4,11,Bronze
2241,15376.0,40,116,1221.5599999999997,2,1,2,5,Platinum
2242,15379.0,169,196,3631.89,4,1,1,6,Diamond
2243,15380.0,8,37,1682.3600000000001,1,3,1,5,Platinum
2244,15381.0,213,8,596.85,4,4,3,11,Bronze
2245,15382.0,14,306,5927.860000000001,1,1,1,3,Platinum
2246,15384.0,169,43,635.7600000000001,4,2,3,9,Gold
2247,15385.0,40,12,316.88,2,4,3,9,Gold
2248,15386.0,186,31,394.14,4,3,3,10,Silver
2249,15388.0,270,10,140.54,4,4,4,12,Bronze
2250,15389.0,172,1,500.0,4,4,3,11,Bronze
2251,15392.0,4,85,1515.73,1,2,2,5,Platinum
2252,15393.0,16,12,231.86,1,4,4,9,Gold
2253,15394.0,9,85,2183.5400000000004,1,2,1,4,Platinum
2254,15395.0,325,7,107.45000000000002,4,4,4,12,Bronze
2255,15396.0,112,14,288.17999999999995,3,4,4,11,Bronze
2256,15397.0,289,6,94.0,4,4,4,12,Bronze
2257,15398.0,16,74,1339.63,1,2,2,5,Platinum
2258,15399.0,1,50,815.77,1,2,2,5,Platinum
2259,15400.0,92,13,666.7,3,4,2,9,Gold
2260,15402.0,148,42,626.77,4,2,3,9,Gold
2261,15405.0,189,8,349.1,4,4,3,11,Bronze
2262,15406.0,18,58,426.60999999999996,2,2,3,7,Diamond
2263,15407.0,33,148,1046.74,2,1,2,5,Platinum
2264,15408.0,264,34,267.18,4,3,4,11,Bronze
2265,15410.0,84,122,3450.8400000000006,3,1,1,5,Platinum
2266,15411.0,26,99,1336.43,2,2,2,6,Diamond
2267,15412.0,171,10,190.53,4,4,4,12,Bronze
2268,15414.0,9,39,774.9,1,3,2,6,Diamond
2269,15415.0,313,47,559.6099999999998,4,2,3,9,Gold
2270,15416.0,64,193,3974.37,3,1,1,5,Platinum
2271,15417.0,85,28,508.80000000000007,3,3,3,9,Gold
2272,15419.0,24,8,135.85999999999999,2,4,4,10,Silver
2273,15421.0,58,53,950.36,3,2,2,7,Diamond
2274,15422.0,323,6,97.7,4,4,4,12,Bronze
2275,15423.0,38,2,43.5,2,4,4,10,Silver
2276,15424.0,254,17,383.34000000000003,4,4,3,11,Bronze
2277,15426.0,19,283,1386.58,2,1,2,5,Platinum
2278,15427.0,33,292,1430.54,2,1,2,5,Platinum
2279,15428.0,15,6,93.78,1,4,4,9,Gold
2280,15429.0,26,83,364.9,2,2,3,7,Diamond
2281,15432.0,23,10,171.19,2,4,4,10,Silver
2282,15433.0,79,53,417.87,3,2,3,8,Gold
2283,15434.0,8,59,997.4799999999999,1,2,2,5,Platinum
2284,15435.0,22,29,149.29000000000002,2,3,4,9,Gold
2285,15436.0,12,291,1067.75,1,1,2,4,Platinum
2286,15437.0,262,45,200.16,4,2,4,10,Silver
2287,15438.0,131,25,156.57999999999998,3,3,4,10,Silver
2288,15440.0,54,62,383.68,3,2,3,8,Gold
2289,15442.0,248,2,594.0,4,4,3,11,Bronze
2290,15443.0,1,375,3188.84,1,1,1,3,Platinum
2291,15444.0,9,214,1411.2100000000003,1,1,2,4,Platinum
2292,15445.0,264,5,113.5,4,4,4,12,Bronze
2293,15447.0,330,9,155.17,4,4,4,12,Bronze
2294,15448.0,312,28,494.64,4,3,3,10,Silver
2295,15449.0,26,62,971.22,2,2,2,6,Diamond
2296,15450.0,30,30,429.84,2,3,3,8,Gold
2297,15452.0,29,56,528.48,2,2,3,7,Diamond
2298,15453.0,1,279,1371.77,1,1,2,4,Platinum
2299,15454.0,362,25,179.10000000000002,4,3,4,11,Bronze
2300,15456.0,283,58,434.59000000000003,4,2,3,9,Gold
2301,15457.0,262,58,237.07,4,2,4,10,Silver
2302,15458.0,25,7,161.64,2,4,4,10,Silver
2303,15460.0,354,56,214.26,4,2,4,10,Silver
2304,15462.0,94,11,234.6,3,4,4,11,Bronze
2305,15463.0,29,7,126.14,2,4,4,10,Silver
2306,15464.0,338,155,1044.65,4,1,2,7,Diamond
2307,15465.0,19,104,6945.02,2,1,1,4,Platinum
2308,15466.0,85,57,334.53000000000003,3,2,3,8,Gold
2309,15467.0,9,53,511.88000000000005,1,2,3,6,Diamond
2310,15468.0,35,29,438.46000000000004,2,3,3,8,Gold
2311,15469.0,43,27,504.50000000000006,2,3,3,8,Gold
2312,15471.0,2,73,454.48,1,2,3,6,Diamond
2313,15472.0,113,76,371.5600000000001,3,2,3,8,Gold
2314,15473.0,14,14,1465.2,1,4,2,7,Diamond
2315,15475.0,77,29,454.10999999999996,3,3,3,9,Gold
2316,15478.0,40,44,1399.9199999999998,2,2,2,6,Diamond
2317,15480.0,116,45,905.5,3,2,2,7,Diamond
2318,15482.0,15,126,6393.5199999999995,1,1,1,3,Platinum
2319,15483.0,161,84,225.26000000000002,4,2,4,10,Silver
2320,15484.0,1,188,3559.21,1,1,1,3,Platinum
2321,15485.0,30,85,2564.5,2,2,1,5,Platinum
2322,15488.0,92,2,91.32000000000001,3,4,4,11,Bronze
2323,15489.0,22,55,1090.03,2,2,2,6,Diamond
2324,15491.0,95,155,3090.85,3,1,1,5,Platinum
2325,15492.0,28,35,659.4599999999998,2,3,2,7,Diamond
2326,15493.0,32,291,1918.8600000000001,2,1,1,4,Platinum
2327,15494.0,21,122,1280.58,2,1,2,5,Platinum
2328,15497.0,17,16,1259.6999999999998,2,4,2,8,Gold
2329,15498.0,0,523,12396.46,1,1,1,3,Platinum
2330,15500.0,8,68,1131.5600000000002,1,2,2,5,Platinum
2331,15502.0,15,252,5541.460000000001,1,1,1,3,Platinum
2332,15503.0,362,66,141.04,4,2,4,10,Silver
2333,15504.0,81,13,52.83,3,4,4,11,Bronze
2334,15505.0,52,99,3497.1400000000003,3,2,1,6,Diamond
2335,15506.0,22,161,972.0799999999999,2,1,2,5,Platinum
2336,15507.0,171,45,475.86000000000007,4,2,3,9,Gold
2337,15508.0,189,92,1000.2700000000001,4,2,2,8,Gold
2338,15510.0,330,1,250.0,4,4,4,12,Bronze
2339,15511.0,11,158,900.53,1,1,2,4,Platinum
2340,15512.0,155,7,121.0,4,4,4,12,Bronze
2341,15513.0,31,314,14520.080000000002,2,1,1,4,Platinum
2342,15514.0,12,197,2907.45,1,1,1,3,Platinum
2343,15516.0,44,15,62.43,2,4,4,10,Silver
2344,15517.0,233,27,267.03000000000003,4,3,4,11,Bronze
2345,15518.0,64,216,1890.99,3,1,1,5,Platinum
2346,15520.0,1,18,343.5,1,3,3,7,Diamond
2347,15521.0,36,200,2574.6499999999996,2,1,1,4,Platinum
2348,15522.0,32,56,397.98999999999995,2,2,3,7,Diamond
2349,15523.0,84,10,412.01,3,4,3,10,Silver
2350,15524.0,24,1,440.0,2,4,3,9,Gold
2351,15525.0,2,158,719.47,1,1,2,4,Platinum
2352,15526.0,33,4,148.44,2,4,4,10,Silver
2353,15527.0,18,165,2347.5700000000006,2,1,1,4,Platinum
2354,15528.0,254,26,229.32999999999998,4,3,4,11,Bronze
2355,15529.0,22,664,3935.15,2,1,1,4,Platinum
2356,15530.0,21,107,1497.3100000000002,2,1,2,5,Platinum
2357,15531.0,8,219,1972.3899999999999,1,1,1,3,Platinum
2358,15532.0,25,258,1500.88,2,1,2,5,Platinum
2359,15533.0,19,86,746.9200000000001,2,2,2,6,Diamond
2360,15535.0,173,75,426.4,4,2,3,9,Gold
2361,15537.0,163,24,110.92000000000002,4,3,4,11,Bronze
2362,15539.0,7,41,538.46,1,3,3,7,Diamond
2363,15540.0,11,15,213.30000000000004,1,4,4,9,Gold
2364,15541.0,114,29,85.13,3,3,4,10,Silver
2365,15543.0,288,28,127.86,4,3,4,11,Bronze
2366,15544.0,8,261,3542.51,1,1,1,3,Platinum
2367,15545.0,54,80,288.97,3,2,4,9,Gold
2368,15547.0,7,695,4910.6,1,1,1,3,Platinum
2369,15549.0,77,115,1643.9599999999998,3,1,1,5,Platinum
2370,15550.0,4,61,575.6300000000002,1,2,3,6,Diamond
2371,15551.0,36,29,436.05999999999995,2,3,3,8,Gold
2372,15552.0,217,17,90.12,4,4,4,12,Bronze
2373,15553.0,60,55,428.92999999999995,3,2,3,8,Gold
2374,15554.0,277,14,217.2,4,4,4,12,Bronze
2375,15555.0,12,913,4747.89,1,1,1,3,Platinum
2376,15556.0,24,31,279.77,2,3,4,9,Gold
2377,15557.0,28,19,468.90999999999997,2,3,3,8,Gold
2378,15561.0,11,31,722.7399999999999,1,3,2,6,Diamond
2379,15562.0,351,1,134.55,4,4,4,12,Bronze
2380,15563.0,8,117,1319.69,1,1,2,4,Platinum
2381,15565.0,50,8,173.16000000000003,2,4,4,10,Silver
2382,15567.0,18,7,186.01000000000002,2,4,4,10,Silver
2383,15568.0,2,53,758.29,1,2,2,5,Platinum
2384,15569.0,103,31,1375.71,3,3,2,8,Gold
2385,15570.0,7,326,4093.2700000000004,1,1,1,3,Platinum
2386,15571.0,11,57,650.4300000000001,1,2,2,5,Platinum
2387,15572.0,4,212,2533.42,1,1,1,3,Platinum
2388,15573.0,31,97,591.1899999999999,2,2,3,7,Diamond
2389,15574.0,177,152,675.64,4,1,2,7,Diamond
2390,15576.0,37,43,921.37,2,2,2,6,Diamond
2391,15577.0,151,39,258.88000000000005,4,3,4,11,Bronze
2392,15578.0,162,13,127.1,4,4,4,12,Bronze
2393,15579.0,68,48,327.59999999999997,3,2,3,8,Gold
2394,15581.0,120,148,3425.77,3,1,1,5,Platinum
2395,15582.0,24,44,682.9100000000001,2,2,2,6,Diamond
2396,15584.0,23,124,718.3600000000001,2,1,2,5,Platinum
2397,15585.0,176,31,455.29999999999995,4,3,3,10,Silver
2398,15587.0,50,9,913.6800000000001,2,4,2,8,Gold
2399,15589.0,252,30,456.58,4,3,3,10,Silver
2400,15590.0,289,1,-30.19,4,4,4,12,Bronze
2401,15592.0,46,24,388.58,2,3,3,8,Gold
2402,15593.0,70,5,199.8,3,4,4,11,Bronze
2403,15594.0,15,104,1767.53,1,1,1,3,Platinum
2404,15596.0,100,84,1343.3400000000001,3,2,2,7,Diamond
2405,15597.0,29,23,315.71999999999997,2,3,3,8,Gold
2406,15598.0,35,16,235.68,2,4,4,10,Silver
2407,15599.0,26,52,761.74,2,2,2,6,Diamond
2408,15601.0,11,414,6745.360000000001,1,1,1,3,Platinum
2409,15602.0,8,54,1083.63,1,2,2,5,Platinum
2410,15603.0,78,2,48.480000000000004,3,4,4,11,Bronze
2411,15604.0,52,17,216.39,3,4,4,11,Bronze
2412,15605.0,36,67,1198.23,2,2,2,6,Diamond
2413,15606.0,57,91,2422.64,3,2,1,6,Diamond
2414,15607.0,336,13,104.76,4,4,4,12,Bronze
2415,15608.0,28,60,1093.68,2,2,2,6,Diamond
2416,15609.0,182,18,270.03000000000003,4,3,4,11,Bronze
2417,15610.0,51,6,112.46,3,4,4,11,Bronze
2418,15611.0,9,45,1568.39,1,2,2,5,Platinum
2419,15612.0,36,6,195.15,2,4,4,10,Silver
2420,15615.0,10,429,10360.04,1,1,1,3,Platinum
2421,15618.0,32,49,747.0310000000001,2,2,2,6,Diamond
2422,15619.0,10,3,336.40000000000003,1,4,3,8,Gold
2423,15620.0,50,104,1524.4,2,1,2,5,Platinum
2424,15621.0,4,18,1158.77,1,3,2,6,Diamond
2425,15622.0,3,214,3224.53,1,1,1,3,Platinum
2426,15623.0,141,19,301.03,3,3,3,9,Gold
2427,15624.0,116,34,588.13,3,3,3,9,Gold
2428,15625.0,100,68,1504.56,3,2,2,7,Diamond
2429,15626.0,74,49,675.8000000000001,3,2,2,7,Diamond
2430,15628.0,4,157,2865.64,1,1,1,3,Platinum
2431,15630.0,45,61,1180.3999999999999,2,2,2,6,Diamond
2432,15632.0,15,177,3147.3100000000004,1,1,1,3,Platinum
2433,15634.0,17,15,243.55,2,4,4,10,Silver
2434,15636.0,89,25,724.76,3,3,2,8,Gold
2435,15637.0,52,15,223.36,3,4,4,11,Bronze
2436,15638.0,301,2,-94.0,4,4,4,12,Bronze
2437,15639.0,134,25,425.32,3,3,3,9,Gold
2438,15640.0,4,486,12336.74,1,1,1,3,Platinum
2439,15641.0,105,119,1887.2,3,1,1,5,Platinum
2440,15643.0,179,36,647.4000000000001,4,3,2,9,Gold
2441,15644.0,166,232,803.54,4,1,2,7,Diamond
2442,15645.0,18,52,612.01,2,2,3,7,Diamond
2443,15646.0,157,36,425.14,4,3,3,10,Silver
2444,15648.0,204,27,582.05,4,3,3,10,Silver
2445,15649.0,336,2,816.0,4,4,2,10,Silver
2446,15651.0,36,32,646.3,2,3,2,7,Diamond
2447,15652.0,91,21,337.74,3,3,3,9,Gold
2448,15653.0,92,6,877.4399999999999,3,4,2,9,Gold
2449,15654.0,9,21,922.5300000000001,1,3,2,6,Diamond
2450,15655.0,233,37,511.32000000000005,4,3,3,10,Silver
2451,15656.0,45,47,748.5,2,2,2,6,Diamond
2452,15657.0,22,1,30.0,2,4,4,10,Silver
2453,15658.0,190,56,958.9,4,2,2,8,Gold
2454,15659.0,43,11,306.45000000000005,2,4,3,9,Gold
2455,15660.0,25,94,1552.0099999999998,2,2,2,6,Diamond
2456,15661.0,317,5,309.8,4,4,3,11,Bronze
2457,15663.0,106,9,138.14,3,4,4,11,Bronze
2458,15664.0,50,19,358.63,2,3,3,8,Gold
2459,15665.0,168,115,2222.2099999999996,4,1,1,6,Diamond
2460,15667.0,39,13,301.32000000000005,2,4,3,9,Gold
2461,15668.0,217,1,76.32000000000001,4,4,4,12,Bronze
2462,15669.0,40,35,677.69,2,3,2,7,Diamond
2463,15670.0,296,12,173.05,4,4,4,12,Bronze
2464,15671.0,18,81,2635.49,2,2,1,5,Platinum
2465,15673.0,88,138,2726.2300000000005,3,1,1,5,Platinum
2466,15674.0,73,135,1744.0199999999998,3,1,1,5,Platinum
2467,15675.0,81,21,323.69,3,3,3,9,Gold
2468,15676.0,9,216,3324.09,1,1,1,3,Platinum
2469,15677.0,49,33,657.23,2,3,2,7,Diamond
2470,15678.0,52,12,352.70000000000005,3,4,3,10,Silver
2471,15679.0,24,110,781.2800000000001,2,1,2,5,Platinum
2472,15680.0,9,78,1333.6799999999998,1,2,2,5,Platinum
2473,15681.0,18,67,946.3599999999999,2,2,2,6,Diamond
2474,15683.0,117,10,193.75,3,4,4,11,Bronze
2475,15687.0,8,168,2981.5,1,1,1,3,Platinum
2476,15689.0,119,9,254.1,3,4,4,11,Bronze
2477,15690.0,4,19,239.76,1,3,4,8,Gold
2478,15691.0,252,2,136.8,4,4,4,12,Bronze
2479,15692.0,28,12,191.03999999999996,2,4,4,10,Silver
2480,15694.0,0,79,6423.599999999999,1,2,1,4,Platinum
2481,15695.0,266,22,409.98,4,3,3,10,Silver
2482,15696.0,33,174,2619.11,2,1,1,4,Platinum
2483,15699.0,17,18,309.6499999999999,2,3,3,8,Gold
2484,15700.0,172,89,664.0300000000001,4,2,2,8,Gold
2485,15701.0,2,230,1529.0,1,1,2,4,Platinum
2486,15703.0,264,5,211.5,4,4,4,12,Bronze
2487,15704.0,140,117,2293.62,3,1,1,5,Platinum
2488,15705.0,201,6,143.10000000000002,4,4,4,12,Bronze
2489,15706.0,59,59,1001.8100000000001,3,2,2,7,Diamond
2490,15707.0,35,205,916.9799999999998,2,1,2,5,Platinum
2491,15708.0,40,282,3200.7300000000005,2,1,1,4,Platinum
2492,15709.0,283,6,133.25,4,4,4,12,Bronze
2493,15712.0,9,53,1072.36,1,2,2,5,Platinum
2494,15713.0,143,20,346.75,3,3,3,9,Gold
2495,15714.0,11,34,330.03,1,3,3,7,Diamond
2496,15716.0,145,117,1101.1100000000001,4,1,2,7,Diamond
2497,15717.0,234,7,150.3,4,4,4,12,Bronze
2498,15719.0,32,932,5028.42,2,1,1,4,Platinum
2499,15720.0,24,128,598.73,2,1,3,6,Diamond
2500,15721.0,11,84,471.4000000000001,1,2,3,6,Diamond
2501,15722.0,35,70,2169.86,2,2,1,5,Platinum
2502,15723.0,364,38,190.70000000000002,4,3,4,11,Bronze
2503,15724.0,201,12,212.3,4,4,4,12,Bronze
2504,15725.0,15,32,415.25,1,3,3,7,Diamond
2505,15727.0,16,301,5159.0599999999995,1,1,1,3,Platinum
2506,15728.0,49,4,-134.8,2,4,4,10,Silver
2507,15729.0,198,6,62.0,4,4,4,12,Bronze
2508,15730.0,65,73,1108.38,3,2,2,7,Diamond
2509,15732.0,212,14,294.11999999999995,4,4,3,11,Bronze
2510,15733.0,282,10,162.3,4,4,4,12,Bronze
2511,15734.0,114,26,1339.45,3,3,2,8,Gold
2512,15737.0,14,79,1121.2099999999998,1,2,2,5,Platinum
2513,15738.0,18,176,4788.77,2,1,1,4,Platinum
2514,15739.0,66,8,449.12,3,4,3,10,Silver
2515,15740.0,49,9,154.88000000000002,2,4,4,10,Silver
2516,15743.0,16,86,775.9599999999999,1,2,2,5,Platinum
2517,15744.0,77,3,34.8,3,4,4,11,Bronze
2518,15745.0,8,65,1071.24,1,2,2,5,Platinum
2519,15746.0,134,29,182.96000000000004,3,3,4,10,Silver
2520,15747.0,12,90,946.6399999999999,1,2,2,5,Platinum
2521,15748.0,40,20,144.35999999999999,2,3,4,9,Gold
2522,15749.0,235,15,21535.9,4,4,1,9,Gold
2523,15750.0,2,293,2448.7999999999997,1,1,1,3,Platinum
2524,15752.0,39,406,2618.15,2,1,1,4,Platinum
2525,15753.0,304,1,79.2,4,4,4,12,Bronze
2526,15754.0,50,29,455.67,2,3,3,8,Gold
2527,15755.0,1,149,2318.88,1,1,1,3,Platinum
2528,15756.0,61,191,528.01,3,1,3,7,Diamond
2529,15757.0,65,45,714.4200000000001,3,2,2,7,Diamond
2530,15758.0,24,9,205.25,2,4,4,10,Silver
2531,15759.0,218,7,253.04000000000002,4,4,4,12,Bronze
2532,15762.0,65,37,583.75,3,3,3,9,Gold
2533,15763.0,31,63,1048.67,2,2,2,6,Diamond
2534,15764.0,81,188,3245.4699999999993,3,1,1,5,Platinum
2535,15766.0,64,11,315.05999999999995,3,4,3,10,Silver
2536,15768.0,115,28,581.8299999999999,3,3,3,9,Gold
2537,15769.0,7,147,51823.72,1,1,1,3,Platinum
2538,15773.0,5,10,635.6800000000001,1,4,3,8,Gold
2539,15774.0,68,25,270.79999999999995,3,3,4,10,Silver
2540,15775.0,245,7,104.9,4,4,4,12,Bronze
2541,15776.0,133,18,241.61999999999998,3,3,4,10,Silver
2542,15777.0,241,22,1021.61,4,3,2,9,Gold
2543,15780.0,183,29,475.28,4,3,3,10,Silver
2544,15781.0,25,21,333.56,2,3,3,8,Gold
2545,15782.0,9,44,2593.9400000000005,1,2,1,4,Platinum
2546,15783.0,10,14,246.3,1,4,4,9,Gold
2547,15785.0,29,87,2303.7500000000005,2,2,1,5,Platinum
2548,15786.0,43,279,4821.0,2,1,1,4,Platinum
2549,15787.0,26,200,933.26,2,1,2,5,Platinum
2550,15789.0,358,25,351.3,4,3,3,10,Silver
2551,15790.0,10,34,218.75000000000003,1,3,4,8,Gold
2552,15791.0,43,76,1604.4399999999998,2,2,2,6,Diamond
2553,15793.0,9,13,948.9599999999999,1,4,2,7,Diamond
2554,15795.0,149,42,610.01,4,2,3,9,Gold
2555,15796.0,1,134,2663.6600000000003,1,1,1,3,Platinum
2556,15797.0,113,8,2207.4,3,4,1,8,Gold
2557,15799.0,75,98,884.14,3,2,2,7,Diamond
2558,15800.0,107,117,696.89,3,1,2,6,Diamond
2559,15801.0,46,69,1042.1899999999998,2,2,2,6,Diamond
2560,15802.0,142,3,-451.42,3,4,4,11,Bronze
2561,15803.0,51,8,415.82000000000005,3,4,3,10,Silver
2562,15804.0,0,274,3848.55,1,1,1,3,Platinum
2563,15805.0,23,305,5411.87,2,1,1,4,Platinum
2564,15806.0,46,31,784.5799999999999,2,3,2,7,Diamond
2565,15807.0,50,48,903.9000000000001,2,2,2,6,Diamond
2566,15808.0,306,197,3641.0699999999997,4,1,1,6,Diamond
2567,15809.0,35,43,399.21,2,2,3,7,Diamond
2568,15810.0,78,112,1145.43,3,1,2,6,Diamond
2569,15811.0,17,139,2171.3199999999997,2,1,1,4,Platinum
2570,15812.0,107,41,1801.14,3,3,1,7,Diamond
2571,15813.0,207,40,1303.9099999999999,4,3,2,9,Gold
2572,15814.0,3,74,1842.73,1,2,1,4,Platinum
2573,15815.0,63,49,2100.6,3,2,1,6,Diamond
2574,15819.0,49,123,1905.4500000000003,2,1,1,4,Platinum
2575,15820.0,319,17,206.98,4,4,4,12,Bronze
2576,15821.0,44,62,570.9599999999999,2,2,3,7,Diamond
2577,15822.0,3,33,885.4699999999999,1,3,2,6,Diamond
2578,15823.0,337,17,-840.7599999999999,4,4,4,12,Bronze
2579,15825.0,172,20,532.94,4,3,3,10,Silver
2580,15826.0,51,69,1649.3600000000001,3,2,1,6,Diamond
2581,15827.0,73,134,1641.4800000000002,3,1,1,5,Platinum
2582,15829.0,99,51,636.1399999999998,3,2,3,8,Gold
2583,15830.0,29,41,547.7,2,3,3,8,Gold
2584,15831.0,58,67,740.6400000000001,3,2,2,7,Diamond
2585,15832.0,254,54,836.7900000000001,4,2,2,8,Gold
2586,15834.0,70,272,2076.3,3,1,1,5,Platinum
2587,15835.0,44,50,954.09,2,2,2,6,Diamond
2588,15836.0,45,12,117.47,2,4,4,10,Silver
2589,15837.0,64,24,391.98,3,3,3,9,Gold
2590,15838.0,11,169,33350.759999999995,1,1,1,3,Platinum
2591,15839.0,25,65,1020.7400000000001,2,2,2,6,Diamond
2592,15840.0,58,28,345.65999999999997,3,3,3,9,Gold
2593,15841.0,64,50,1209.1,3,2,2,7,Diamond
2594,15843.0,303,8,118.95000000000002,4,4,4,12,Bronze
2595,15844.0,46,11,130.73999999999998,2,4,4,10,Silver
2596,15845.0,17,140,3650.87,2,1,1,4,Platinum
2597,15847.0,38,22,389.2699999999999,2,3,3,8,Gold
2598,15850.0,19,93,234.88,2,2,4,8,Gold
2599,15852.0,186,22,160.70999999999998,4,3,4,11,Bronze
2600,15853.0,51,30,110.80000000000001,3,3,4,10,Silver
2601,15854.0,4,138,2969.12,1,1,1,3,Platinum
2602,15855.0,136,80,712.24,3,2,2,7,Diamond
2603,15856.0,4,636,15929.740000000002,1,1,1,3,Platinum
2604,15857.0,18,14,296.99999999999994,2,4,3,9,Gold
2605,15858.0,15,188,1427.5700000000002,1,1,2,4,Platinum
2606,15860.0,40,139,965.1599999999999,2,1,2,5,Platinum
2607,15861.0,12,541,2981.92,1,1,1,3,Platinum
2608,15862.0,8,147,832.88,1,1,2,4,Platinum
2609,15863.0,25,18,68.84,2,3,4,9,Gold
2610,15864.0,22,24,1769.7800000000002,2,3,1,6,Diamond
2611,15865.0,40,40,895.13,2,3,2,7,Diamond
2612,15866.0,101,43,211.89,3,2,4,9,Gold
2613,15867.0,5,461,3795.29,1,1,1,3,Platinum
2614,15869.0,277,15,149.64000000000001,4,4,4,12,Bronze
2615,15870.0,32,74,351.44000000000005,2,2,3,7,Diamond
2616,15872.0,14,108,316.25000000000006,1,1,3,5,Platinum
2617,15874.0,63,137,4330.67,3,1,1,5,Platinum
2618,15877.0,1,128,437.83000000000004,1,1,3,5,Platinum
2619,15880.0,369,97,299.03,4,2,3,9,Gold
2620,15881.0,312,32,438.24,4,3,3,10,Silver
2621,15882.0,198,24,495.36000000000007,4,3,3,10,Silver
2622,15883.0,2,49,396.47999999999996,1,2,3,6,Diamond
2623,15885.0,92,18,379.35,3,3,3,9,Gold
2624,15886.0,60,12,181.09000000000003,3,4,4,11,Bronze
2625,15888.0,79,14,141.26999999999998,3,4,4,11,Bronze
2626,15889.0,156,85,420.07,4,2,3,9,Gold
2627,15891.0,226,60,511.67999999999995,4,2,3,9,Gold
2628,15894.0,253,37,258.25,4,3,4,11,Bronze
2629,15895.0,149,11,179.17000000000002,4,4,4,12,Bronze
2630,15897.0,194,22,208.59000000000003,4,3,4,11,Bronze
2631,15898.0,1,85,1379.6299999999999,1,2,2,5,Platinum
2632,15899.0,368,4,56.25,4,4,4,12,Bronze
2633,15900.0,23,47,337.28000000000003,2,2,3,7,Diamond
2634,15901.0,16,111,351.73,1,1,3,5,Platinum
2635,15903.0,9,75,5126.34,1,2,1,4,Platinum
2636,15904.0,8,30,164.67999999999998,1,3,4,8,Gold
2637,15906.0,19,151,1521.79,2,1,2,5,Platinum
2638,15907.0,3,226,882.72,1,1,2,4,Platinum
2639,15909.0,173,7,191.93999999999997,4,4,4,12,Bronze
2640,15910.0,0,266,1228.88,1,1,2,4,Platinum
2641,15912.0,178,19,264.61999999999995,4,3,4,11,Bronze
2642,15916.0,16,156,1466.0100000000002,1,1,2,4,Platinum
2643,15917.0,247,12,123.10000000000001,4,4,4,12,Bronze
2644,15918.0,190,40,334.23,4,3,3,10,Silver
2645,15919.0,19,122,525.6899999999999,2,1,3,6,Diamond
2646,15920.0,154,60,167.5,4,2,4,10,Silver
2647,15921.0,172,24,323.03,4,3,3,10,Silver
2648,15922.0,372,12,363.6000000000001,4,4,3,11,Bronze
2649,15923.0,372,21,127.08000000000001,4,3,4,11,Bronze
2650,15925.0,194,12,207.14999999999998,4,4,4,12,Bronze
2651,15930.0,67,21,426.63000000000005,3,3,3,9,Gold
2652,15932.0,4,119,2461.8500000000004,1,1,1,3,Platinum
2653,15933.0,21,74,1107.4600000000003,2,2,2,6,Diamond
2654,15935.0,239,12,416.86,4,4,3,11,Bronze
2655,15937.0,64,7,145.35,3,4,4,11,Bronze
2656,15938.0,112,18,404.58,3,3,3,9,Gold
2657,15939.0,89,77,6102.259999999999,3,2,1,6,Diamond
2658,15940.0,311,2,31.799999999999997,4,4,4,12,Bronze
2659,15942.0,133,14,337.43999999999994,3,4,3,10,Silver
2660,15944.0,276,6,325.1,4,4,3,11,Bronze
2661,15945.0,365,2,181.0,4,4,4,12,Bronze
2662,15947.0,82,29,1708.24,3,3,1,7,Diamond
2663,15948.0,8,60,955.2400000000001,1,2,2,5,Platinum
2664,15949.0,16,19,364.72,1,3,3,7,Diamond
2665,15950.0,1,102,1684.4599999999998,1,1,1,3,Platinum
2666,15951.0,1,43,669.5699999999999,1,2,2,5,Platinum
2667,15952.0,33,84,781.9100000000001,2,2,2,6,Diamond
2668,15953.0,15,102,1632.4299999999996,1,1,1,3,Platinum
2669,15955.0,24,185,4389.81,2,1,1,4,Platinum
2670,15957.0,31,42,428.89000000000004,2,2,3,7,Diamond
2671,15958.0,74,7,104.35,3,4,4,11,Bronze
2672,15963.0,19,28,470.76000000000005,2,3,3,8,Gold
2673,15965.0,17,111,808.87,2,1,2,5,Platinum
2674,15967.0,23,80,397.67999999999995,2,2,3,7,Diamond
2675,15969.0,2,21,582.8999999999999,1,3,3,7,Diamond
2676,15970.0,303,11,314.1,4,4,3,11,Bronze
2677,15971.0,17,35,4199.85,2,3,1,6,Diamond
2678,15973.0,235,6,99.77,4,4,4,12,Bronze
2679,15974.0,39,177,3429.55,2,1,1,4,Platinum
2680,15975.0,84,24,371.01,3,3,3,9,Gold
2681,15976.0,165,96,427.64000000000004,4,2,3,9,Gold
2682,15977.0,17,65,1054.73,2,2,2,6,Diamond
2683,15978.0,77,49,1098.78,3,2,2,7,Diamond
2684,15980.0,88,43,2398.8599999999997,3,2,1,6,Diamond
2685,15981.0,24,97,3408.48,2,2,1,5,Platinum
2686,15983.0,22,112,1465.12,2,1,2,5,Platinum
2687,15984.0,2,263,2759.9300000000003,1,1,1,3,Platinum
2688,15985.0,123,38,1037.42,3,3,2,8,Gold
2689,15986.0,30,14,168.11999999999998,2,4,4,10,Silver
2690,15987.0,12,128,1432.77,1,1,2,4,Platinum
2691,15988.0,19,26,156.78,2,3,4,9,Gold
2692,15990.0,44,52,792.1100000000001,2,2,2,6,Diamond
2693,15992.0,3,3,41.989999999999995,1,4,4,9,Gold
2694,15993.0,8,551,2736.92,1,1,1,3,Platinum
2695,15994.0,54,32,414.27000000000004,3,3,3,9,Gold
2696,15996.0,88,128,1016.6800000000001,3,1,2,6,Diamond
2697,15998.0,36,507,3074.42,2,1,1,4,Platinum
2698,16000.0,2,9,12393.699999999999,1,4,1,6,Diamond
2699,16003.0,29,103,2735.37,2,1,1,4,Platinum
2700,16005.0,12,201,578.71,1,1,3,5,Platinum
2701,16006.0,211,8,101.4,4,4,4,12,Bronze
2702,16007.0,47,381,1693.81,2,1,1,4,Platinum
2703,16008.0,23,33,478.78000000000003,2,3,3,8,Gold
2704,16009.0,22,82,972.1100000000001,2,2,2,6,Diamond
2705,16010.0,245,79,392.4,4,2,3,9,Gold
2706,16011.0,8,210,3352.96,1,1,1,3,Platinum
2707,16012.0,35,94,1415.29,2,2,2,6,Diamond
2708,16013.0,3,151,33366.25,1,1,1,3,Platinum
2709,16014.0,35,141,637.5799999999999,2,1,3,6,Diamond
2710,16015.0,3,183,689.6999999999999,1,1,2,4,Platinum
2711,16016.0,3,226,1440.06,1,1,2,4,Platinum
2712,16017.0,47,32,211.88,2,3,4,9,Gold
2713,16018.0,39,28,408.90000000000003,2,3,3,8,Gold
2714,16019.0,1,165,3450.24,1,1,1,3,Platinum
2715,16020.0,16,46,851.01,1,2,2,5,Platinum
2716,16022.0,260,71,602.6300000000001,4,2,3,9,Gold
2717,16023.0,46,101,719.81,2,1,2,5,Platinum
2718,16024.0,12,63,251.03,1,2,4,7,Diamond
2719,16025.0,29,28,439.65999999999997,2,3,3,8,Gold
2720,16026.0,43,32,236.09,2,3,4,9,Gold
2721,16027.0,91,17,852.12,3,4,2,9,Gold
2722,16029.0,38,270,53168.69,2,1,1,4,Platinum
2723,16030.0,309,29,331.24,4,3,3,10,Silver
2724,16031.0,92,98,547.9000000000001,3,2,3,8,Gold
2725,16033.0,5,1143,8690.029999999999,1,1,1,3,Platinum
2726,16034.0,196,22,437.69999999999993,4,3,3,10,Silver
2727,16036.0,87,55,758.9199999999998,3,2,2,7,Diamond
2728,16037.0,269,39,855.0200000000001,4,3,2,9,Gold
2729,16038.0,7,28,454.33,1,3,3,7,Diamond
2730,16040.0,65,65,1313.5500000000002,3,2,2,7,Diamond
2731,16041.0,30,6,3166.4,2,4,1,7,Diamond
2732,16042.0,22,74,1127.5700000000002,2,2,2,6,Diamond
2733,16043.0,37,39,773.99,2,3,2,7,Diamond
2734,16045.0,119,83,1340.7,3,2,2,7,Diamond
2735,16048.0,85,9,243.69000000000005,3,4,4,11,Bronze
2736,16049.0,40,299,1074.81,2,1,2,5,Platinum
2737,16050.0,173,10,137.89999999999998,4,4,4,12,Bronze
2738,16052.0,54,34,362.05999999999995,3,3,3,9,Gold
2739,16053.0,32,84,1511.9500000000003,2,2,2,6,Diamond
2740,16054.0,145,70,783.9000000000001,4,2,2,8,Gold
2741,16055.0,220,8,134.8,4,4,4,12,Bronze
2742,16056.0,45,66,650.75,2,2,2,6,Diamond
2743,16057.0,4,134,2140.22,1,1,1,3,Platinum
2744,16059.0,65,178,1453.1599999999999,3,1,2,6,Diamond
2745,16061.0,269,1,-29.95,4,4,4,12,Bronze
2746,16062.0,9,64,1153.62,1,2,2,5,Platinum
2747,16063.0,260,23,335.32000000000005,4,3,3,10,Silver
2748,16065.0,365,73,367.14,4,2,3,9,Gold
2749,16066.0,16,101,1521.0400000000004,1,1,2,4,Platinum
2750,16070.0,22,33,852.15,2,3,2,7,Diamond
2751,16071.0,44,21,326.24,2,3,3,8,Gold
2752,16072.0,288,23,584.32,4,3,3,10,Silver
2753,16073.0,291,2,94.35,4,4,4,12,Bronze
2754,16076.0,3,131,2173.5299999999997,1,1,1,3,Platinum
2755,16078.0,283,1,79.2,4,4,4,12,Bronze
2756,16079.0,16,21,1352.0000000000002,1,3,2,6,Diamond
2757,16080.0,81,11,176.60000000000002,3,4,4,11,Bronze
2758,16081.0,56,223,2799.42,3,1,1,5,Platinum
2759,16083.0,100,31,1317.62,3,3,2,8,Gold
2760,16084.0,299,38,436.18,4,3,3,10,Silver
2761,16085.0,23,167,981.51,2,1,2,5,Platinum
2762,16086.0,59,40,1119.31,3,3,2,8,Gold
2763,16091.0,154,18,315.06,4,3,3,10,Silver
2764,16092.0,98,53,779.36,3,2,2,7,Diamond
2765,16093.0,106,1,17.0,3,4,4,11,Bronze
2766,16094.0,11,67,1041.83,1,2,2,5,Platinum
2767,16096.0,264,12,320.62,4,4,3,11,Bronze
2768,16097.0,240,10,185.05,4,4,4,12,Bronze
2769,16098.0,87,67,2005.63,3,2,1,6,Diamond
2770,16099.0,50,39,731.8999999999997,2,3,2,7,Diamond
2771,16101.0,9,83,1245.9599999999998,1,2,2,5,Platinum
2772,16102.0,42,57,1842.14,2,2,1,5,Platinum
2773,16103.0,7,48,1429.6399999999999,1,2,2,5,Platinum
2774,16104.0,61,28,298.21000000000004,3,3,3,9,Gold
2775,16105.0,248,13,336.96,4,4,3,11,Bronze
2776,16106.0,65,6,108.38,3,4,4,11,Bronze
2777,16107.0,17,31,3204.16,2,3,1,6,Diamond
2778,16108.0,84,49,816.1,3,2,2,7,Diamond
2779,16109.0,218,18,611.8800000000001,4,3,3,10,Silver
2780,16110.0,45,342,1320.9500000000003,2,1,2,5,Platinum
2781,16112.0,143,16,195.74,3,4,4,11,Bronze
2782,16113.0,183,30,161.38,4,3,4,11,Bronze
2783,16114.0,170,8,135.75000000000003,4,4,4,12,Bronze
2784,16115.0,9,279,1660.8799999999999,1,1,1,3,Platinum
2785,16116.0,205,35,592.8800000000001,4,3,3,10,Silver
2786,16117.0,189,30,232.21,4,3,4,11,Bronze
2787,16119.0,8,16,423.36,1,4,3,8,Gold
2788,16120.0,59,32,1294.14,3,3,2,8,Gold
2789,16121.0,57,204,854.66,3,1,2,6,Diamond
2790,16122.0,73,38,684.42,3,3,2,8,Gold
2791,16123.0,51,16,307.78000000000003,3,4,3,10,Silver
2792,16124.0,316,16,187.14999999999998,4,4,4,12,Bronze
2793,16125.0,367,13,289.35,4,4,4,12,Bronze
2794,16126.0,29,117,6287.77,2,1,1,4,Platinum
2795,16127.0,39,40,656.25,2,3,2,7,Diamond
2796,16128.0,17,89,1880.2199999999998,2,2,1,5,Platinum
2797,16131.0,51,78,3506.540000000001,3,2,1,6,Diamond
2798,16133.0,3,365,14305.66,1,1,1,3,Platinum
2799,16134.0,21,38,603.6900000000002,2,3,3,8,Gold
2800,16135.0,262,21,517.5500000000001,4,3,3,10,Silver
2801,16136.0,59,37,709.3800000000002,3,3,2,8,Gold
2802,16138.0,368,1,-7.95,4,4,4,12,Bronze
2803,16139.0,18,31,635.4100000000001,2,3,3,8,Gold
2804,16140.0,52,37,703.7700000000001,3,3,2,8,Gold
2805,16141.0,88,30,620.4,3,3,3,9,Gold
2806,16142.0,249,37,535.3399999999999,4,3,3,10,Silver
2807,16143.0,3,118,2419.8399999999997,1,1,1,3,Platinum
2808,16144.0,246,1,175.2,4,4,4,12,Bronze
2809,16145.0,8,237,3741.9799999999996,1,1,1,3,Platinum
2810,16146.0,157,29,734.1299999999999,4,3,2,9,Gold
2811,16147.0,133,22,374.99999999999994,3,3,3,9,Gold
2812,16148.0,296,1,76.32000000000001,4,4,4,12,Bronze
2813,16149.0,4,18,280.52000000000004,1,3,4,8,Gold
2814,16150.0,38,136,1906.07,2,1,1,4,Platinum
2815,16152.0,268,29,1829.0399999999997,4,3,1,8,Gold
2816,16153.0,49,89,1824.23,2,2,1,5,Platinum
2817,16156.0,8,137,2994.6200000000003,1,1,1,3,Platinum
2818,16157.0,15,19,644.2399999999999,1,3,2,6,Diamond
2819,16159.0,281,14,348.2000000000001,4,4,3,11,Bronze
2820,16160.0,64,22,1009.4500000000004,3,3,2,8,Gold
2821,16161.0,1,499,5311.08,1,1,1,3,Platinum
2822,16162.0,252,2,37.4,4,4,4,12,Bronze
2823,16163.0,225,7,441.6000000000001,4,4,3,11,Bronze
2824,16164.0,17,35,802.53,2,3,2,7,Diamond
2825,16168.0,10,99,3770.6000000000004,1,2,1,4,Platinum
2826,16169.0,8,85,1822.9700000000003,1,2,1,4,Platinum
2827,16170.0,50,127,1880.42,2,1,1,4,Platinum
2828,16171.0,59,3,73.2,3,4,4,11,Bronze
2829,16172.0,95,69,1140.2100000000003,3,2,2,7,Diamond
2830,16173.0,15,87,1406.5700000000002,1,2,2,5,Platinum
2831,16174.0,126,23,1009.55,3,3,2,8,Gold
2832,16175.0,94,58,1037.5900000000001,3,2,2,7,Diamond
2833,16177.0,50,15,331.95,2,4,3,9,Gold
2834,16178.0,138,8,197.9,3,4,4,11,Bronze
2835,16179.0,60,11,215.83,3,4,4,11,Bronze
2836,16180.0,100,176,10217.48,3,1,1,5,Platinum
2837,16181.0,73,11,305.5400000000001,3,4,3,10,Silver
2838,16182.0,72,28,6617.65,3,3,1,7,Diamond
2839,16183.0,67,15,338.7100000000001,3,4,3,10,Silver
2840,16184.0,64,46,1155.54,3,2,2,7,Diamond
2841,16185.0,16,31,529.4100000000001,1,3,3,7,Diamond
2842,16186.0,22,219,3991.9399999999996,2,1,1,4,Platinum
2843,16187.0,31,297,6841.24,2,1,1,4,Platinum
2844,16188.0,44,67,981.8599999999999,2,2,2,6,Diamond
2845,16189.0,15,11,215.47999999999996,1,4,4,9,Gold
2846,16190.0,40,6,215.08,2,4,4,10,Silver
2847,16191.0,2,151,4913.320000000001,1,1,1,3,Platinum
2848,16193.0,236,19,314.45000000000005,4,3,3,10,Silver
2849,16198.0,75,15,400.681,3,4,3,10,Silver
2850,16200.0,4,172,1068.87,1,1,2,4,Platinum
2851,16201.0,3,115,1821.5200000000002,1,1,1,3,Platinum
2852,16202.0,360,18,365.27,4,3,3,10,Silver
2853,16203.0,58,36,589.15,3,3,3,9,Gold
2854,16204.0,23,50,384.18,2,2,3,7,Diamond
2855,16205.0,30,97,757.63,2,2,2,6,Diamond
2856,16206.0,54,63,537.0600000000001,3,2,3,8,Gold
2857,16207.0,25,19,394.38,2,3,3,8,Gold
2858,16208.0,44,66,664.26,2,2,2,6,Diamond
2859,16209.0,88,46,2262.6199999999994,3,2,1,6,Diamond
2860,16210.0,1,123,21086.300000000003,1,1,1,3,Platinum
2861,16211.0,81,24,542.77,3,3,3,9,Gold
2862,16212.0,19,43,681.19,2,2,2,6,Diamond
2863,16213.0,78,6,159.0,3,4,4,11,Bronze
2864,16214.0,170,44,1062.75,4,2,2,8,Gold
2865,16215.0,80,14,242.35000000000002,3,4,4,11,Bronze
2866,16216.0,267,37,914.9299999999998,4,3,2,9,Gold
2867,16217.0,235,19,259.39,4,3,4,11,Bronze
2868,16218.0,29,90,3054.87,2,2,1,5,Platinum
2869,16221.0,36,95,860.86,2,2,2,6,Diamond
2870,16222.0,318,122,773.5500000000001,4,1,2,7,Diamond
2871,16224.0,57,96,1295.3,3,2,2,7,Diamond
2872,16225.0,44,134,1096.3200000000002,2,1,2,5,Platinum
2873,16226.0,203,8,255.12,4,4,4,12,Bronze
2874,16227.0,219,7,308.32000000000005,4,4,3,11,Bronze
2875,16229.0,87,47,1010.5999999999998,3,2,2,7,Diamond
2876,16230.0,189,35,542.03,4,3,3,10,Silver
2877,16232.0,32,38,983.2299999999999,2,3,2,7,Diamond
2878,16233.0,71,25,422.13,3,3,3,9,Gold
2879,16235.0,40,48,858.41,2,2,2,6,Diamond
2880,16236.0,78,20,432.19999999999993,3,3,3,9,Gold
2881,16239.0,56,21,372.9,3,3,3,9,Gold
2882,16240.0,8,142,3693.8100000000004,1,1,1,3,Platinum
2883,16241.0,9,655,2590.3100000000004,1,1,1,3,Platinum
2884,16242.0,8,293,3574.91,1,1,1,3,Platinum
2885,16243.0,33,51,409.1,2,2,3,7,Diamond
2886,16244.0,211,91,1522.75,4,2,2,8,Gold
2887,16245.0,23,93,1352.3600000000001,2,2,2,6,Diamond
2888,16247.0,170,16,114.56,4,4,4,12,Bronze
2889,16248.0,61,7,152.94,3,4,4,11,Bronze
2890,16249.0,52,69,1800.0700000000002,3,2,1,6,Diamond
2891,16250.0,261,24,389.44,4,3,3,10,Silver
2892,16252.0,366,21,-295.09000000000003,4,3,4,11,Bronze
2893,16253.0,31,124,3665.62,2,1,1,4,Platinum
2894,16255.0,16,274,2609.3,1,1,1,3,Platinum
2895,16256.0,257,14,732.6300000000002,4,4,2,10,Silver
2896,16257.0,176,2,46.95,4,4,4,12,Bronze
2897,16258.0,45,135,5203.510000000001,2,1,1,4,Platinum
2898,16260.0,50,18,1035.45,2,3,2,7,Diamond
2899,16261.0,17,119,728.5400000000001,2,1,2,5,Platinum
2900,16262.0,360,3,-31.65,4,4,4,12,Bronze
2901,16265.0,9,260,5423.15,1,1,1,3,Platinum
2902,16266.0,73,61,861.8899999999999,3,2,2,7,Diamond
2903,16268.0,71,45,667.6500000000001,3,2,2,7,Diamond
2904,16270.0,353,54,1141.2399999999996,4,2,2,8,Gold
2905,16271.0,2,131,1398.69,1,1,2,4,Platinum
2906,16272.0,116,25,411.7,3,3,3,9,Gold
2907,16274.0,373,65,351.75,4,2,3,9,Gold
2908,16275.0,196,33,559.87,4,3,3,10,Silver
2909,16276.0,176,6,810.6000000000001,4,4,2,10,Silver
2910,16278.0,23,25,537.8299999999999,2,3,3,8,Gold
2911,16279.0,21,108,1489.88,2,1,2,5,Platinum
2912,16281.0,72,17,2062.0600000000004,3,4,1,8,Gold
2913,16282.0,339,11,168.3,4,4,4,12,Bronze
2914,16283.0,5,168,1531.51,1,1,2,4,Platinum
2915,16284.0,31,103,812.68,2,1,2,5,Platinum
2916,16287.0,169,8,142.5,4,4,4,12,Bronze
2917,16292.0,117,19,280.90000000000003,3,3,4,10,Silver
2918,16293.0,8,120,2236.74,1,1,1,3,Platinum
2919,16295.0,9,79,1328.5500000000004,1,2,2,5,Platinum
2920,16297.0,212,23,275.4000000000001,4,3,4,11,Bronze
2921,16298.0,22,27,598.1999999999999,2,3,3,8,Gold
2922,16302.0,107,12,212.82,3,4,4,11,Bronze
2923,16303.0,25,167,5305.83,2,1,1,4,Platinum
2924,16305.0,138,22,361.21999999999986,3,3,3,9,Gold
2925,16306.0,213,44,602.2700000000001,4,2,3,9,Gold
2926,16308.0,37,4,2560.0,2,4,1,7,Diamond
2927,16309.0,91,44,686.67,3,2,2,7,Diamond
2928,16311.0,17,37,616.26,2,3,3,8,Gold
2929,16313.0,3,16,274.15000000000003,1,4,4,9,Gold
2930,16315.0,330,14,226.37,4,4,4,12,Bronze
2931,16316.0,64,156,2755.5599999999995,3,1,1,5,Platinum
2932,16317.0,119,69,1341.65,3,2,2,7,Diamond
2933,16318.0,35,19,328.15,2,3,3,8,Gold
2934,16319.0,217,3,404.40000000000003,4,4,3,11,Bronze
2935,16320.0,172,56,1038.46,4,2,2,8,Gold
2936,16321.0,72,16,230.70000000000002,3,4,4,11,Bronze
2937,16322.0,1,37,326.74999999999994,1,3,3,7,Diamond
2938,16323.0,196,1,207.50000000000003,4,4,4,12,Bronze
2939,16324.0,128,111,408.58999999999986,3,1,3,7,Diamond
2940,16325.0,44,20,510.5400000000001,2,3,3,8,Gold
2941,16326.0,5,301,3014.2200000000003,1,1,1,3,Platinum
2942,16327.0,14,317,3820.27,1,1,1,3,Platinum
2943,16330.0,17,41,242.21,2,3,4,9,Gold
2944,16332.0,28,152,1572.8000000000002,2,1,2,5,Platinum
2945,16333.0,7,45,26626.8,1,2,1,4,Platinum
2946,16337.0,36,10,151.05,2,4,4,10,Silver
2947,16338.0,157,11,214.8,4,4,4,12,Bronze
2948,16339.0,284,18,94.05000000000001,4,3,4,11,Bronze
2949,16340.0,107,141,534.31,3,1,3,7,Diamond
2950,16341.0,24,84,1959.38,2,2,1,5,Platinum
2951,16342.0,75,15,322.41,3,4,3,10,Silver
2952,16343.0,16,43,328.58000000000004,1,2,3,6,Diamond
2953,16344.0,158,2,101.10000000000001,4,4,4,12,Bronze
2954,16345.0,44,37,565.46,2,3,3,8,Gold
2955,16347.0,11,85,847.45,1,2,2,5,Platinum
2956,16348.0,32,222,1415.65,2,1,2,5,Platinum
2957,16349.0,290,9,53.5,4,4,4,12,Bronze
2958,16350.0,21,60,1100.4699999999998,2,2,2,6,Diamond
2959,16351.0,332,8,153.9,4,4,4,12,Bronze
2960,16352.0,17,28,494.44,2,3,3,8,Gold
2961,16353.0,3,94,6675.710000000001,1,2,1,4,Platinum
2962,16354.0,63,39,395.8,3,3,3,9,Gold
2963,16356.0,197,32,210.32,4,3,4,11,Bronze
2964,16357.0,33,34,658.88,2,3,2,7,Diamond
2965,16358.0,1,110,2024.95,1,1,1,3,Platinum
2966,16359.0,7,70,1460.37,1,2,2,5,Platinum
2967,16360.0,4,645,3349.5699999999997,1,1,1,3,Platinum
2968,16361.0,9,104,891.21,1,1,2,4,Platinum
2969,16362.0,32,86,627.29,2,2,3,7,Diamond
2970,16363.0,53,5,109.36000000000001,3,4,4,11,Bronze
2971,16364.0,11,52,705.7899999999998,1,2,2,5,Platinum
2972,16365.0,17,51,1540.42,2,2,2,6,Diamond
2973,16366.0,18,18,327.3,2,3,3,8,Gold
2974,16367.0,37,127,800.6699999999996,2,1,2,5,Platinum
2975,16368.0,2,69,479.90999999999997,1,2,3,6,Diamond
2976,16369.0,18,117,1545.4100000000003,2,1,2,5,Platinum
2977,16370.0,82,221,1301.9099999999999,3,1,2,6,Diamond
2978,16372.0,33,92,355.72999999999996,2,2,3,7,Diamond
2979,16374.0,66,109,466.72999999999996,3,1,3,7,Diamond
2980,16376.0,8,125,965.4700000000001,1,1,2,4,Platinum
2981,16377.0,267,5,676.2,4,4,2,10,Silver
2982,16378.0,247,23,362.9500000000001,4,3,3,10,Silver
2983,16379.0,4,109,2131.9000000000005,1,1,1,3,Platinum
2984,16380.0,61,31,1743.15,3,3,1,7,Diamond
2985,16383.0,74,98,643.7599999999999,3,2,3,8,Gold
2986,16384.0,89,33,584.5,3,3,3,9,Gold
2987,16385.0,60,57,554.8599999999999,3,2,3,8,Gold
2988,16386.0,28,81,302.56999999999994,2,2,3,7,Diamond
2989,16387.0,322,4,94.36,4,4,4,12,Bronze
2990,16389.0,53,35,1362.2699999999998,3,3,2,8,Gold
2991,16392.0,269,43,217.89,4,2,4,10,Silver
2992,16393.0,2,355,2935.8,1,1,1,3,Platinum
2993,16394.0,50,100,1412.0600000000002,2,1,2,5,Platinum
2994,16395.0,60,206,1482.0600000000002,3,1,2,6,Diamond
2995,16398.0,144,86,1631.15,4,2,1,7,Diamond
2996,16399.0,19,72,408.02,2,2,3,7,Diamond
2997,16400.0,94,29,303.93,3,3,3,9,Gold
2998,16401.0,1,198,4061.24,1,1,1,3,Platinum
2999,16402.0,264,57,293.45,4,2,3,9,Gold
3000,16403.0,302,15,161.04999999999998,4,4,4,12,Bronze
3001,16404.0,70,23,443.05000000000007,3,3,3,9,Gold
3002,16405.0,302,5,167.25,4,4,4,12,Bronze
3003,16406.0,18,59,154.35000000000002,2,2,4,8,Gold
3004,16407.0,12,168,2079.6800000000003,1,1,1,3,Platinum
3005,16409.0,36,231,2022.9800000000002,2,1,1,4,Platinum
3006,16411.0,19,44,211.7,2,2,4,8,Gold
3007,16412.0,53,30,135.99,3,3,4,10,Silver
3008,16413.0,56,31,262.2,3,3,4,10,Silver
3009,16414.0,21,7,126.25,2,4,4,10,Silver
3010,16415.0,44,47,200.26999999999995,2,2,4,8,Gold
3011,16416.0,26,73,1026.99,2,2,2,6,Diamond
3012,16418.0,44,95,631.1200000000001,2,2,3,7,Diamond
3013,16419.0,112,51,945.96,3,2,2,7,Diamond
3014,16422.0,17,399,33805.69,2,1,1,4,Platinum
3015,16423.0,24,18,346.12,2,3,3,8,Gold
3016,16424.0,191,6,82.56,4,4,4,12,Bronze
3017,16425.0,302,21,302.69999999999993,4,3,3,10,Silver
3018,16426.0,2,353,1863.76,1,1,1,3,Platinum
3019,16427.0,263,9,241.06,4,4,4,12,Bronze
3020,16428.0,81,1,-2.95,3,4,4,11,Bronze
3021,16429.0,106,2,284.55,3,4,4,11,Bronze
3022,16430.0,57,6,300.85,3,4,3,10,Silver
3023,16431.0,213,76,623.2799999999999,4,2,3,9,Gold
3024,16432.0,64,8,287.4,3,4,4,11,Bronze
3025,16433.0,28,17,184.26,2,4,4,10,Silver
3026,16434.0,29,107,1511.8000000000002,2,1,2,5,Platinum
3027,16438.0,5,132,798.35,1,1,2,4,Platinum
3028,16440.0,7,282,3640.6699999999996,1,1,1,3,Platinum
3029,16441.0,67,24,381.2,3,3,3,9,Gold
3030,16442.0,1,171,609.3,1,1,3,5,Platinum
3031,16444.0,46,86,638.7700000000001,2,2,3,7,Diamond
3032,16445.0,33,63,230.51000000000002,2,2,4,8,Gold
3033,16446.0,0,4,2.8999999999941792,1,4,4,9,Gold
3034,16447.0,135,34,255.91,3,3,4,10,Silver
3035,16448.0,198,19,182.99,4,3,4,11,Bronze
3036,16449.0,190,43,674.6900000000002,4,2,2,8,Gold
3037,16450.0,149,11,311.92,4,4,3,11,Bronze
3038,16451.0,87,14,266.97,3,4,4,11,Bronze
3039,16454.0,44,3,-8.15,2,4,4,10,Silver
3040,16455.0,63,99,1841.18,3,2,1,6,Diamond
3041,16456.0,99,110,2158.1800000000003,3,1,1,5,Platinum
3042,16457.0,218,9,208.35999999999999,4,4,4,12,Bronze
3043,16458.0,2,202,3482.7400000000007,1,1,1,3,Platinum
3044,16460.0,28,132,811.23,2,1,2,5,Platinum
3045,16461.0,177,32,142.92,4,3,4,11,Bronze
3046,16462.0,64,4,102.0,3,4,4,11,Bronze
3047,16463.0,21,85,1383.6999999999998,2,2,2,6,Diamond
3048,16464.0,19,230,1298.66,2,1,2,5,Platinum
3049,16466.0,33,146,1595.96,2,1,2,5,Platinum
3050,16468.0,74,2,74.9,3,4,4,11,Bronze
3051,16469.0,23,171,625.4200000000001,2,1,3,6,Diamond
3052,16470.0,51,165,747.82,3,1,2,6,Diamond
3053,16471.0,274,13,223.95,4,4,4,12,Bronze
3054,16473.0,164,19,314.86,4,3,3,10,Silver
3055,16474.0,7,345,1750.62,1,1,1,3,Platinum
3056,16475.0,88,28,544.3,3,3,3,9,Gold
3057,16477.0,63,146,2494.46,3,1,1,5,Platinum
3058,16478.0,25,17,331.0,2,4,3,9,Gold
3059,16479.0,10,35,300.83,1,3,3,7,Diamond
3060,16480.0,75,53,769.29,3,2,2,7,Diamond
3061,16482.0,15,18,220.62,1,3,4,8,Gold
3062,16483.0,192,19,139.35,4,3,4,11,Bronze
3063,16484.0,173,26,379.4000000000001,4,3,3,10,Silver
3064,16485.0,77,42,363.65,3,2,3,8,Gold
3065,16488.0,33,31,492.20000000000005,2,3,3,8,Gold
3066,16491.0,46,39,731.5,2,3,2,7,Diamond
3067,16493.0,72,62,1329.66,3,2,2,7,Diamond
3068,16494.0,296,50,826.5299999999999,4,2,2,8,Gold
3069,16495.0,3,88,648.26,1,2,2,5,Platinum
3070,16496.0,8,97,1562.22,1,2,2,5,Platinum
3071,16497.0,49,136,2965.69,2,1,1,4,Platinum
3072,16498.0,161,16,86.12,4,4,4,12,Bronze
3073,16499.0,360,22,319.1,4,3,3,10,Silver
3074,16500.0,4,11,400.86,1,4,3,8,Gold
3075,16503.0,106,86,1421.4299999999998,3,2,2,7,Diamond
3076,16504.0,25,83,465.88000000000005,2,2,3,7,Diamond
3077,16505.0,31,4,777.6,2,4,2,8,Gold
3078,16506.0,19,3,90.30000000000001,2,4,4,10,Silver
3079,16509.0,296,13,363.70000000000005,4,4,3,11,Bronze
3080,16510.0,372,13,248.10000000000002,4,4,4,12,Bronze
3081,16511.0,21,159,918.33,2,1,2,5,Platinum
3082,16513.0,4,35,874.5899999999999,1,3,2,6,Diamond
3083,16515.0,52,111,1624.14,3,1,1,5,Platinum
3084,16516.0,30,6,101.7,2,4,4,10,Silver
3085,16517.0,277,17,162.70000000000005,4,4,4,12,Bronze
3086,16518.0,61,42,480.9200000000001,3,2,3,8,Gold
3087,16519.0,25,13,215.08,2,4,4,10,Silver
3088,16520.0,186,157,1036.62,4,1,2,7,Diamond
3089,16523.0,1,298,9295.67,1,1,1,3,Platinum
3090,16525.0,2,200,11895.57,1,1,1,3,Platinum
3091,16526.0,171,15,290.35999999999996,4,4,4,12,Bronze
3092,16527.0,81,14,228.06000000000003,3,4,4,11,Bronze
3093,16528.0,3,17,244.41000000000003,1,4,4,9,Gold
3094,16529.0,190,30,455.25,4,3,3,10,Silver
3095,16531.0,22,77,1244.59,2,2,2,6,Diamond
3096,16532.0,17,4,6748.8,2,4,1,7,Diamond
3097,16533.0,19,180,1014.19,2,1,2,5,Platinum
3098,16535.0,5,31,593.75,1,3,3,7,Diamond
3099,16536.0,107,55,538.17,3,2,3,8,Gold
3100,16539.0,2,45,1388.81,1,2,2,5,Platinum
3101,16542.0,53,5,119.62,3,4,4,11,Bronze
3102,16545.0,164,3,339.3,4,4,3,11,Bronze
3103,16546.0,290,31,-95.92999999999998,4,3,4,11,Bronze
3104,16549.0,10,925,4034.9,1,1,1,3,Platinum
3105,16550.0,108,261,2266.25,3,1,1,5,Platinum
3106,16551.0,95,32,922.12,3,3,2,8,Gold
3107,16552.0,242,17,379.73,4,4,3,11,Bronze
3108,16553.0,163,86,5664.57,4,2,1,7,Diamond
3109,16554.0,3,74,641.55,1,2,3,6,Diamond
3110,16555.0,35,17,285.89,2,4,4,10,Silver
3111,16556.0,66,207,3313.79,3,1,1,5,Platinum
3112,16557.0,24,11,281.84999999999997,2,4,4,10,Silver
3113,16558.0,0,474,8257.04,1,1,1,3,Platinum
3114,16560.0,21,58,816.5100000000001,2,2,2,6,Diamond
3115,16561.0,5,31,511.12,1,3,3,7,Diamond
3116,16563.0,53,19,1077.74,3,3,2,8,Gold
3117,16565.0,364,3,173.7,4,4,4,12,Bronze
3118,16566.0,15,19,614.01,1,3,3,7,Diamond
3119,16567.0,194,35,865.6,4,3,2,9,Gold
3120,16569.0,3,5,124.2,1,4,4,9,Gold
3121,16570.0,8,133,3622.95,1,1,1,3,Platinum
3122,16571.0,3,106,1285.2199999999998,1,1,2,4,Platinum
3123,16572.0,127,58,999.7,3,2,2,7,Diamond
3124,16573.0,73,46,648.41,3,2,2,7,Diamond
3125,16574.0,71,28,451.43999999999994,3,3,3,9,Gold
3126,16579.0,365,1,-30.599999999999998,4,4,4,12,Bronze
3127,16581.0,155,11,70.44,4,4,4,12,Bronze
3128,16582.0,113,6,313.61999999999995,3,4,3,10,Silver
3129,16583.0,373,14,233.45000000000002,4,4,4,12,Bronze
3130,16584.0,80,31,908.0299999999999,3,3,2,8,Gold
3131,16586.0,248,8,463.95,4,4,3,11,Bronze
3132,16587.0,232,13,225.14999999999995,4,4,4,12,Bronze
3133,16589.0,71,33,459.24,3,3,3,9,Gold
3134,16591.0,68,10,213.5,3,4,4,11,Bronze
3135,16592.0,4,222,4073.2800000000007,1,1,1,3,Platinum
3136,16593.0,50,27,330.03000000000003,2,3,3,8,Gold
3137,16594.0,75,53,181.09,3,2,4,9,Gold
3138,16595.0,61,85,360.15999999999997,3,2,3,8,Gold
3139,16596.0,15,12,250.14999999999998,1,4,4,9,Gold
3140,16597.0,4,7,90.04000000000002,1,4,4,9,Gold
3141,16598.0,277,11,140.70000000000002,4,4,4,12,Bronze
3142,16600.0,4,62,813.5199999999999,1,2,2,5,Platinum
3143,16601.0,40,30,242.69999999999996,2,3,4,9,Gold
3144,16602.0,31,32,494.73,2,3,3,8,Gold
3145,16603.0,74,34,482.47,3,3,3,9,Gold
3146,16607.0,17,174,3038.6699999999996,2,1,1,4,Platinum
3147,16609.0,15,280,5450.960000000001,1,1,1,3,Platinum
3148,16610.0,219,6,75.66,4,4,4,12,Bronze
3149,16611.0,186,11,120.99,4,4,4,12,Bronze
3150,16612.0,32,66,1187.6599999999999,2,2,2,6,Diamond
3151,16613.0,70,30,618.5900000000001,3,3,3,9,Gold
3152,16614.0,182,26,506.19,4,3,3,10,Silver
3153,16616.0,15,33,500.42,1,3,3,7,Diamond
3154,16617.0,235,5,151.85000000000002,4,4,4,12,Bronze
3155,16618.0,31,97,2630.6400000000003,2,2,1,5,Platinum
3156,16619.0,253,16,204.41,4,4,4,12,Bronze
3157,16620.0,3,9,178.96,1,4,4,9,Gold
3158,16621.0,51,29,813.4800000000001,3,3,2,8,Gold
3159,16623.0,245,5,129.45,4,4,4,12,Bronze
3160,16624.0,80,48,810.5699999999999,3,2,2,7,Diamond
3161,16625.0,274,23,333.08,4,3,3,10,Silver
3162,16626.0,0,184,4379.65,1,1,1,3,Platinum
3163,16627.0,79,20,322.80000000000007,3,3,3,9,Gold
3164,16628.0,29,119,2183.0400000000004,2,1,1,4,Platinum
3165,16629.0,73,60,408.63,3,2,3,8,Gold
3166,16633.0,17,153,2878.1499999999996,2,1,1,4,Platinum
3167,16634.0,222,9,217.9,4,4,4,12,Bronze
3168,16637.0,32,72,1124.59,2,2,2,6,Diamond
3169,16638.0,22,95,1676.47,2,2,1,5,Platinum
3170,16639.0,25,52,1169.38,2,2,2,6,Diamond
3171,16641.0,105,12,231.10000000000002,3,4,4,11,Bronze
3172,16642.0,4,35,679.83,1,3,2,6,Diamond
3173,16643.0,245,27,487.51,4,3,3,10,Silver
3174,16644.0,177,62,833.78,4,2,2,8,Gold
3175,16647.0,169,14,214.06,4,4,4,12,Bronze
3176,16648.0,38,21,270.85999999999996,2,3,4,9,Gold
3177,16650.0,71,24,518.4200000000001,3,3,3,9,Gold
3178,16652.0,53,123,6654.26,3,1,1,5,Platinum
3179,16653.0,16,76,1166.9200000000003,1,2,2,5,Platinum
3180,16654.0,141,31,594.9699999999999,3,3,3,9,Gold
3181,16655.0,17,258,3789.52,2,1,1,4,Platinum
3182,16656.0,22,80,8568.24,2,2,1,5,Platinum
3183,16657.0,9,192,874.43,1,1,2,4,Platinum
3184,16658.0,368,8,123.24,4,4,4,12,Bronze
3185,16659.0,189,2,39.12,4,4,4,12,Bronze
3186,16660.0,16,17,810.45,1,4,2,7,Diamond
3187,16665.0,362,9,135.39999999999998,4,4,4,12,Bronze
3188,16666.0,19,32,118.97999999999999,2,3,4,9,Gold
3189,16667.0,68,52,567.18,3,2,3,8,Gold
3190,16668.0,15,20,306.71999999999997,1,3,3,7,Diamond
3191,16669.0,23,157,1344.88,2,1,2,5,Platinum
3192,16670.0,16,262,4022.46,1,1,1,3,Platinum
3193,16671.0,28,6,1692.27,2,4,1,7,Diamond
3194,16672.0,2,117,8093.59,1,1,1,3,Platinum
3195,16674.0,54,93,304.24,3,2,3,8,Gold
3196,16676.0,33,92,1558.72,2,2,2,6,Diamond
3197,16678.0,2,170,3013.83,1,1,1,3,Platinum
3198,16679.0,366,3,129.75,4,4,4,12,Bronze
3199,16680.0,43,10,183.7,2,4,4,10,Silver
3200,16681.0,72,44,1770.3400000000001,3,2,1,6,Diamond
3201,16682.0,4,30,1027.9999999999998,1,3,2,6,Diamond
3202,16684.0,4,281,65892.08,1,1,1,3,Platinum
3203,16685.0,61,62,324.24,3,2,3,8,Gold
3204,16686.0,47,547,2940.5299999999997,2,1,1,4,Platinum
3205,16688.0,1,62,1260.86,1,2,2,5,Platinum
3206,16689.0,75,16,303.26,3,4,3,10,Silver
3207,16690.0,43,13,208.62999999999997,2,4,4,10,Silver
3208,16692.0,256,3,1276.0,4,4,2,10,Silver
3209,16693.0,68,59,477.85999999999996,3,2,3,8,Gold
3210,16696.0,135,10,657.9000000000001,3,4,2,9,Gold
3211,16697.0,241,21,112.75000000000001,4,3,4,11,Bronze
3212,16698.0,226,5,1998.0,4,4,1,9,Gold
3213,16700.0,8,312,5040.0,1,1,1,3,Platinum
3214,16701.0,8,154,5150.27,1,1,1,3,Platinum
3215,16705.0,0,284,13946.13,1,1,1,3,Platinum
3216,16706.0,37,123,531.3499999999999,2,1,3,6,Diamond
3217,16708.0,45,27,656.6300000000001,2,3,2,7,Diamond
3218,16709.0,84,79,3029.8700000000003,3,2,1,6,Diamond
3219,16710.0,19,394,2467.99,2,1,1,4,Platinum
3220,16711.0,3,22,1651.03,1,3,1,5,Platinum
3221,16712.0,9,438,3611.31,1,1,1,3,Platinum
3222,16713.0,18,627,6827.88,2,1,1,4,Platinum
3223,16714.0,218,88,879.06,4,2,2,8,Gold
3224,16715.0,78,19,301.71999999999997,3,3,3,9,Gold
3225,16716.0,266,3,319.8000000000001,4,4,3,11,Bronze
3226,16717.0,9,235,3263.06,1,1,1,3,Platinum
3227,16718.0,369,44,606.0500000000001,4,2,3,9,Gold
3228,16719.0,14,198,1753.7200000000003,1,1,1,3,Platinum
3229,16720.0,26,25,152.95,2,3,4,9,Gold
3230,16721.0,262,37,292.46999999999997,4,3,3,10,Silver
3231,16722.0,17,228,4711.21,2,1,1,4,Platinum
3232,16723.0,91,42,576.4,3,2,3,8,Gold
3233,16725.0,302,146,752.3199999999999,4,1,2,7,Diamond
3234,16726.0,26,178,1358.7400000000002,2,1,2,5,Platinum
3235,16727.0,364,44,256.31999999999994,4,2,4,10,Silver
3236,16728.0,46,263,1048.28,2,1,2,5,Platinum
3237,16729.0,36,664,7041.6900000000005,2,1,1,4,Platinum
3238,16730.0,52,84,702.79,3,2,2,7,Diamond
3239,16732.0,31,28,603.7499999999999,2,3,3,8,Gold
3240,16734.0,52,52,646.76,3,2,2,7,Diamond
3241,16735.0,78,119,2216.06,3,1,1,5,Platinum
3242,16737.0,53,1,417.59999999999997,3,4,3,10,Silver
3243,16738.0,297,1,3.75,4,4,4,12,Bronze
3244,16739.0,172,16,312.54999999999995,4,4,3,11,Bronze
3245,16742.0,46,4,0.0,2,4,4,10,Silver
3246,16743.0,29,192,2166.88,2,1,1,4,Platinum
3247,16744.0,11,236,1291.9099999999999,1,1,2,4,Platinum
3248,16745.0,86,356,7157.1,3,1,1,5,Platinum
3249,16746.0,4,447,6676.76,1,1,1,3,Platinum
3250,16747.0,25,45,826.96,2,2,2,6,Diamond
3251,16748.0,17,69,1515.8999999999999,2,2,2,6,Diamond
3252,16750.0,44,95,623.9300000000001,2,2,3,7,Diamond
3253,16751.0,30,25,1764.7199999999998,2,3,1,6,Diamond
3254,16752.0,372,9,207.5,4,4,4,12,Bronze
3255,16753.0,58,34,223.92,3,3,4,10,Silver
3256,16754.0,372,2,2002.4,4,4,1,9,Gold
3257,16755.0,114,171,1463.23,3,1,2,6,Diamond
3258,16756.0,214,13,239.40000000000003,4,4,4,12,Bronze
3259,16757.0,318,7,106.83,4,4,4,12,Bronze
3260,16758.0,65,22,369.34000000000003,3,3,3,9,Gold
3261,16759.0,7,43,772.84,1,2,2,5,Platinum
3262,16761.0,96,13,316.62,3,4,3,10,Silver
3263,16762.0,19,63,1207.24,2,2,2,6,Diamond
3264,16763.0,185,24,594.9,4,3,3,10,Silver
3265,16764.0,3,712,2749.95,1,1,1,3,Platinum
3266,16765.0,294,1,34.0,4,4,4,12,Bronze
3267,16766.0,273,34,1145.5999999999997,4,3,2,9,Gold
3268,16767.0,30,221,5575.5599999999995,2,1,1,4,Platinum
3269,16768.0,47,58,458.03999999999996,2,2,3,7,Diamond
3270,16769.0,260,38,361.5399999999999,4,3,3,10,Silver
3271,16770.0,57,141,731.9,3,1,2,6,Diamond
3272,16771.0,33,254,2242.6099999999997,2,1,1,4,Platinum
3273,16773.0,57,26,171.59,3,3,4,10,Silver
3274,16774.0,67,49,654.9200000000001,3,2,2,7,Diamond
3275,16775.0,10,157,1691.5100000000002,1,1,1,3,Platinum
3276,16776.0,60,71,371.54,3,2,3,8,Gold
3277,16777.0,80,48,222.62,3,2,4,9,Gold
3278,16778.0,74,16,245.94,3,4,4,11,Bronze
3279,16779.0,2,342,10436.05,1,1,1,3,Platinum
3280,16780.0,100,59,422.24,3,2,3,8,Gold
3281,16781.0,365,19,294.65000000000003,4,3,3,10,Silver
3282,16782.0,10,190,2230.3,1,1,1,3,Platinum
3283,16784.0,19,3,107.6,2,4,4,10,Silver
3284,16788.0,123,148,594.3899999999999,3,1,3,7,Diamond
3285,16789.0,8,5,80.8,1,4,4,9,Gold
3286,16790.0,3,95,1520.12,1,2,2,5,Platinum
3287,16791.0,29,316,1690.28,2,1,1,4,Platinum
3288,16792.0,282,12,110.38000000000001,4,4,4,12,Bronze
3289,16793.0,57,16,243.84,3,4,4,11,Bronze
3290,16794.0,1,280,1175.3,1,1,2,4,Platinum
3291,16795.0,365,66,414.87999999999994,4,2,3,9,Gold
3292,16796.0,89,18,305.61999999999995,3,3,3,9,Gold
3293,16800.0,11,156,1162.65,1,1,2,4,Platinum
3294,16801.0,163,120,842.3299999999999,4,1,2,7,Diamond
3295,16803.0,65,24,332.3,3,3,3,9,Gold
3296,16804.0,23,60,536.99,2,2,3,7,Diamond
3297,16805.0,173,98,460.5899999999999,4,2,3,9,Gold
3298,16806.0,103,93,762.1600000000001,3,2,2,7,Diamond
3299,16807.0,142,67,1121.59,3,2,2,7,Diamond
3300,16808.0,99,23,288.42,3,3,4,10,Silver
3301,16809.0,23,150,912.7399999999999,2,1,2,5,Platinum
3302,16810.0,192,16,275.64,4,4,4,12,Bronze
3303,16811.0,4,28,547.0699999999999,1,3,3,7,Diamond
3304,16812.0,360,15,479.3500000000001,4,4,3,11,Bronze
3305,16813.0,8,426,1652.18,1,1,1,3,Platinum
3306,16814.0,14,320,6408.2,1,1,1,3,Platinum
3307,16816.0,103,28,417.06000000000006,3,3,3,9,Gold
3308,16817.0,2,95,1446.95,1,2,2,5,Platinum
3309,16818.0,10,191,3317.9700000000003,1,1,1,3,Platinum
3310,16820.0,95,26,497.61,3,3,3,9,Gold
3311,16823.0,227,38,358.37999999999994,4,3,3,10,Silver
3312,16824.0,15,26,460.64,1,3,3,7,Diamond
3313,16825.0,38,28,775.1800000000001,2,3,2,7,Diamond
3314,16826.0,51,22,341.70000000000005,3,3,3,9,Gold
3315,16828.0,93,8,128.5,3,4,4,11,Bronze
3316,16829.0,156,11,197.22,4,4,4,12,Bronze
3317,16830.0,38,23,325.90999999999997,2,3,3,8,Gold
3318,16832.0,184,12,199.15,4,4,4,12,Bronze
3319,16833.0,1,47,1106.53,1,2,2,5,Platinum
3320,16834.0,227,24,413.46000000000004,4,3,3,10,Silver
3321,16835.0,128,10,180.85000000000002,3,4,4,11,Bronze
3322,16836.0,39,11,251.87,2,4,4,10,Silver
3323,16837.0,31,166,3167.7299999999996,2,1,1,4,Platinum
3324,16838.0,197,26,582.9000000000001,4,3,3,10,Silver
3325,16839.0,8,298,15357.78,1,1,1,3,Platinum
3326,16841.0,36,117,1774.62,2,1,1,4,Platinum
3327,16842.0,64,64,1260.44,3,2,2,7,Diamond
3328,16843.0,42,379,10183.82,2,1,1,4,Platinum
3329,16846.0,50,11,214.32000000000002,2,4,4,10,Silver
3330,16847.0,43,12,193.44,2,4,4,10,Silver
3331,16848.0,52,14,281.42,3,4,4,11,Bronze
3332,16849.0,186,8,124.57,4,4,4,12,Bronze
3333,16850.0,333,19,332.41,4,3,3,10,Silver
3334,16851.0,4,20,342.45000000000005,1,3,3,7,Diamond
3335,16852.0,10,9,144.91,1,4,4,9,Gold
3336,16855.0,23,19,328.40000000000003,2,3,3,8,Gold
3337,16856.0,14,2,35.400000000000006,1,4,4,9,Gold
3338,16858.0,366,13,345.8900000000001,4,4,3,11,Bronze
3339,16859.0,106,72,473.14,3,2,3,8,Gold
3340,16861.0,59,8,151.65,3,4,4,11,Bronze
3341,16863.0,29,28,481.34999999999997,2,3,3,8,Gold
3342,16866.0,140,11,207.73999999999998,3,4,4,11,Bronze
3343,16869.0,22,128,797.32,2,1,2,5,Platinum
3344,16871.0,22,139,2761.49,2,1,1,4,Platinum
3345,16872.0,77,7,680.02,3,4,2,9,Gold
3346,16873.0,4,289,7066.3099999999995,1,1,1,3,Platinum
3347,16875.0,64,123,2023.47,3,1,1,5,Platinum
3348,16877.0,12,156,846.62,1,1,2,4,Platinum
3349,16878.0,24,6,0.0,2,4,4,10,Silver
3350,16880.0,30,174,1491.43,2,1,2,5,Platinum
3351,16881.0,66,1,432.0,3,4,3,10,Silver
3352,16882.0,66,39,705.12,3,3,2,8,Gold
3353,16883.0,187,37,272.47999999999996,4,3,4,11,Bronze
3354,16884.0,37,26,429.84000000000003,2,3,3,8,Gold
3355,16885.0,15,96,450.4100000000001,1,2,3,6,Diamond
3356,16887.0,35,36,192.33,2,3,4,9,Gold
3357,16889.0,194,135,1578.67,4,1,2,7,Diamond
3358,16891.0,1,186,742.4300000000001,1,1,2,4,Platinum
3359,16892.0,1,99,489.49,1,2,3,6,Diamond
3360,16893.0,366,45,145.93,4,2,4,10,Silver
3361,16895.0,64,62,202.26999999999998,3,2,4,9,Gold
3362,16897.0,299,44,213.03000000000003,4,2,4,10,Silver
3363,16898.0,26,158,436.68000000000006,2,1,3,6,Diamond
3364,16899.0,7,123,1271.06,1,1,2,4,Platinum
3365,16900.0,11,82,187.69,1,2,4,7,Diamond
3366,16902.0,116,44,1706.88,3,2,1,6,Diamond
3367,16903.0,29,56,363.2,2,2,3,7,Diamond
3368,16904.0,4,665,3653.7500000000005,1,1,1,3,Platinum
3369,16905.0,5,200,3020.65,1,1,1,3,Platinum
3370,16906.0,81,86,559.5900000000003,3,2,3,8,Gold
3371,16907.0,29,140,928.76,2,1,2,5,Platinum
3372,16909.0,64,19,364.14,3,3,3,9,Gold
3373,16910.0,4,545,1508.9599999999998,1,1,2,4,Platinum
3374,16912.0,23,104,2508.87,2,1,1,4,Platinum
3375,16913.0,290,8,113.44,4,4,4,12,Bronze
3376,16914.0,36,30,183.75999999999996,2,3,4,9,Gold
3377,16915.0,9,57,621.6800000000001,1,2,3,6,Diamond
3378,16916.0,23,136,562.41,2,1,3,6,Diamond
3379,16917.0,276,9,391.52000000000004,4,4,3,11,Bronze
3380,16918.0,49,130,1043.3400000000001,2,1,2,5,Platinum
3381,16919.0,156,326,2592.25,4,1,1,6,Diamond
3382,16921.0,61,55,154.18,3,2,4,9,Gold
3383,16923.0,12,650,6488.3,1,1,1,3,Platinum
3384,16924.0,21,87,722.6399999999999,2,2,2,6,Diamond
3385,16926.0,371,14,230.25000000000003,4,4,4,12,Bronze
3386,16927.0,115,6,543.0500000000001,3,4,3,10,Silver
3387,16928.0,80,208,2748.6,3,1,1,5,Platinum
3388,16929.0,3,77,1295.3899999999999,1,2,2,5,Platinum
3389,16930.0,26,53,378.89,2,2,3,7,Diamond
3390,16931.0,5,886,4554.870000000001,1,1,1,3,Platinum
3391,16932.0,53,48,150.23,3,2,4,9,Gold
3392,16933.0,1,49,530.08,1,2,3,6,Diamond
3393,16934.0,54,61,931.0300000000002,3,2,2,7,Diamond
3394,16936.0,25,56,261.90000000000003,2,2,4,8,Gold
3395,16938.0,8,236,1878.43,1,1,1,3,Platinum
3396,16940.0,52,305,3049.88,3,1,1,5,Platinum
3397,16942.0,12,279,1878.51,1,1,1,3,Platinum
3398,16943.0,211,33,816.7299999999999,4,3,2,9,Gold
3399,16945.0,21,249,4345.5,2,1,1,4,Platinum
3400,16947.0,235,21,406.48,4,3,3,10,Silver
3401,16948.0,138,19,435.02000000000004,3,3,3,9,Gold
3402,16949.0,3,61,1161.2700000000002,1,2,2,5,Platinum
3403,16950.0,56,42,1178.56,3,2,2,7,Diamond
3404,16951.0,123,87,1262.7500000000002,3,2,2,7,Diamond
3405,16952.0,109,16,167.60999999999999,3,4,4,11,Bronze
3406,16953.0,30,1,20.8,2,4,4,10,Silver
3407,16954.0,0,54,2085.08,1,2,1,4,Platinum
3408,16955.0,184,26,493.66999999999996,4,3,3,10,Silver
3409,16956.0,9,18,292.34000000000003,1,3,3,7,Diamond
3410,16957.0,239,16,416.64,4,4,3,11,Bronze
3411,16959.0,87,7,117.35000000000001,3,4,4,11,Bronze
3412,16960.0,38,101,507.05,2,1,3,6,Diamond
3413,16961.0,116,14,234.17000000000002,3,4,4,11,Bronze
3414,16963.0,187,7,110.55000000000001,4,4,4,12,Bronze
3415,16965.0,226,26,201.18999999999994,4,3,4,11,Bronze
3416,16966.0,8,31,2148.4700000000003,1,3,1,5,Platinum
3417,16967.0,189,21,319.02,4,3,3,10,Silver
3418,16968.0,4,31,439.43,1,3,3,7,Diamond
3419,16969.0,39,42,650.4100000000001,2,2,2,6,Diamond
3420,16971.0,2,42,232.20999999999998,1,2,4,7,Diamond
3421,16976.0,267,2,251.51999999999998,4,4,4,12,Bronze
3422,16978.0,77,39,344.3299999999999,3,3,3,9,Gold
3423,16979.0,3,91,1809.05,1,2,1,4,Platinum
3424,16980.0,255,81,1028.46,4,2,2,8,Gold
3425,16982.0,60,22,384.06,3,3,3,9,Gold
3426,16983.0,12,144,1894.82,1,1,1,3,Platinum
3427,16984.0,78,411,4370.59,3,1,1,5,Platinum
3428,16985.0,17,121,5461.619999999999,2,1,1,4,Platinum
3429,16986.0,29,3,1873.2,2,4,1,7,Diamond
3430,16987.0,3,128,1616.8000000000002,1,1,1,3,Platinum
3431,16988.0,5,7,126.12,1,4,4,9,Gold
3432,16989.0,7,12,1133.25,1,4,2,7,Diamond
3433,16990.0,218,1,179.0,4,4,4,12,Bronze
3434,16992.0,10,95,1601.8599999999997,1,2,2,5,Platinum
3435,16995.0,372,1,-1.25,4,4,4,12,Bronze
3436,16996.0,30,41,1427.4600000000003,2,3,2,7,Diamond
3437,16997.0,288,12,702.0,4,4,2,10,Silver
3438,16998.0,149,6,287.02,4,4,4,12,Bronze
3439,16999.0,23,23,484.82,2,3,3,8,Gold
3440,17001.0,0,169,3989.5699999999997,1,1,1,3,Platinum
3441,17002.0,73,50,1487.7800000000002,3,2,2,7,Diamond
3442,17004.0,46,43,1312.14,2,2,2,6,Diamond
3443,17006.0,4,44,781.78,1,2,2,5,Platinum
3444,17007.0,50,53,877.43,2,2,2,6,Diamond
3445,17010.0,16,12,185.46,1,4,4,9,Gold
3446,17011.0,30,15,270.9,2,4,4,10,Silver
3447,17014.0,8,73,562.6800000000001,1,2,3,6,Diamond
3448,17015.0,28,214,1838.6100000000001,2,1,1,4,Platinum
3449,17017.0,2,268,8574.11,1,1,1,3,Platinum
3450,17018.0,40,16,920.1,2,4,2,8,Gold
3451,17019.0,11,228,1258.08,1,1,2,4,Platinum
3452,17022.0,31,7,71.0,2,4,4,10,Silver
3453,17024.0,45,3,95.85,2,4,4,10,Silver
3454,17025.0,60,9,357.77,3,4,3,10,Silver
3455,17026.0,185,4,154.82999999999998,4,4,4,12,Bronze
3456,17027.0,78,150,835.86,3,1,2,6,Diamond
3457,17029.0,110,2,716.0,3,4,2,9,Gold
3458,17030.0,63,11,146.87000000000003,3,4,4,11,Bronze
3459,17031.0,11,22,380.35,1,3,3,7,Diamond
3460,17033.0,86,28,1030.14,3,3,2,8,Gold
3461,17034.0,16,32,734.5699999999999,1,3,2,6,Diamond
3462,17035.0,245,32,388.33,4,3,3,10,Silver
3463,17037.0,78,77,1253.2199999999998,3,2,2,7,Diamond
3464,17038.0,30,22,112.40000000000002,2,3,4,9,Gold
3465,17040.0,137,15,449.72999999999996,3,4,3,10,Silver
3466,17041.0,26,70,1055.6900000000003,2,2,2,6,Diamond
3467,17042.0,2,97,1036.5800000000002,1,2,2,5,Platinum
3468,17043.0,32,102,1735.18,2,1,1,4,Platinum
3469,17044.0,8,10,897.43,1,4,2,7,Diamond
3470,17045.0,113,22,339.43999999999994,3,3,3,9,Gold
3471,17046.0,157,22,642.0199999999999,4,3,3,10,Silver
3472,17047.0,85,65,1100.8999999999999,3,2,2,7,Diamond
3473,17048.0,115,48,864.32,3,2,2,7,Diamond
3474,17049.0,2,321,5589.83,1,1,1,3,Platinum
3475,17050.0,96,308,3185.64,3,1,1,5,Platinum
3476,17051.0,194,42,240.89,4,2,4,10,Silver
3477,17052.0,28,83,399.0899999999999,2,2,3,7,Diamond
3478,17053.0,128,14,496.37999999999994,3,4,3,10,Silver
3479,17054.0,28,84,1353.8300000000002,2,2,2,6,Diamond
3480,17058.0,81,62,1179.8899999999999,3,2,2,7,Diamond
3481,17059.0,29,514,3080.39,2,1,1,4,Platinum
3482,17060.0,266,5,234.24,4,4,4,12,Bronze
3483,17061.0,73,101,5116.129999999999,3,1,1,5,Platinum
3484,17062.0,313,70,529.4300000000001,4,2,3,9,Gold
3485,17063.0,8,82,1421.59,1,2,2,5,Platinum
3486,17064.0,58,61,855.4499999999999,3,2,2,7,Diamond
3487,17065.0,143,1,-112.35,3,4,4,11,Bronze
3488,17068.0,12,297,4531.34,1,1,1,3,Platinum
3489,17069.0,28,154,2655.2200000000003,2,1,1,4,Platinum
3490,17070.0,114,62,304.23999999999995,3,2,3,8,Gold
3491,17071.0,8,148,2385.48,1,1,1,3,Platinum
3492,17073.0,17,174,1446.0900000000001,2,1,2,5,Platinum
3493,17075.0,17,80,813.7700000000001,2,2,2,6,Diamond
3494,17076.0,36,25,841.0799999999999,2,3,2,7,Diamond
3495,17078.0,36,28,378.20000000000005,2,3,3,8,Gold
3496,17079.0,78,2,118.80000000000001,3,4,4,11,Bronze
3497,17080.0,22,9,285.5,2,4,4,10,Silver
3498,17081.0,25,63,288.91,2,2,4,8,Gold
3499,17082.0,33,81,2003.85,2,2,1,5,Platinum
3500,17083.0,109,52,1405.78,3,2,2,7,Diamond
3501,17084.0,35,149,2747.99,2,1,1,4,Platinum
3502,17085.0,123,188,1550.8,3,1,2,6,Diamond
3503,17086.0,7,96,2050.08,1,2,1,4,Platinum
3504,17088.0,28,115,1991.0100000000002,2,1,1,4,Platinum
3505,17090.0,4,62,1972.5500000000004,1,2,1,4,Platinum
3506,17091.0,2,198,3802.8100000000004,1,1,1,3,Platinum
3507,17092.0,50,124,1774.0300000000002,2,1,1,4,Platinum
3508,17094.0,318,15,270.19999999999993,4,4,4,12,Bronze
3509,17095.0,22,77,1088.1999999999998,2,2,2,6,Diamond
3510,17096.0,9,52,992.68,1,2,2,5,Platinum
3511,17097.0,2,213,937.92,1,1,2,4,Platinum
3512,17100.0,18,65,971.74,2,2,2,6,Diamond
3513,17101.0,10,42,1621.73,1,2,1,4,Platinum
3514,17102.0,261,1,25.5,4,4,4,12,Bronze
3515,17105.0,159,90,665.7799999999999,4,2,2,8,Gold
3516,17107.0,32,419,10362.48,2,1,1,4,Platinum
3517,17109.0,29,120,865.9300000000001,2,1,2,5,Platinum
3518,17110.0,165,12,163.3,4,4,4,12,Bronze
3519,17111.0,47,29,231.60999999999999,2,3,4,9,Gold
3520,17114.0,5,131,739.72,1,1,2,4,Platinum
3521,17115.0,8,43,806.8999999999999,1,2,2,5,Platinum
3522,17117.0,288,9,116.19999999999999,4,4,4,12,Bronze
3523,17118.0,317,10,157.02,4,4,4,12,Bronze
3524,17119.0,3,38,593.6099999999999,1,3,3,7,Diamond
3525,17120.0,233,18,307.46000000000004,4,3,3,10,Silver
3526,17122.0,119,7,138.32,3,4,4,11,Bronze
3527,17123.0,161,9,345.29999999999995,4,4,3,11,Bronze
3528,17124.0,185,31,294.24,4,3,3,10,Silver
3529,17125.0,50,35,230.5,2,3,4,9,Gold
3530,17126.0,152,250,976.55,4,1,2,7,Diamond
3531,17128.0,334,14,157.08999999999997,4,4,4,12,Bronze
3532,17131.0,5,134,2463.17,1,1,1,3,Platinum
3533,17133.0,15,27,4892.240000000001,1,3,1,5,Platinum
3534,17134.0,106,23,413.2,3,3,3,9,Gold
3535,17135.0,16,52,1139.73,1,2,2,5,Platinum
3536,17138.0,275,24,380.5,4,3,3,10,Silver
3537,17139.0,15,486,10567.869999999999,1,1,1,3,Platinum
3538,17140.0,247,18,454.12,4,3,3,10,Silver
3539,17142.0,239,15,578.9999999999999,4,4,3,11,Bronze
3540,17144.0,1,48,984.5699999999999,1,2,2,5,Platinum
3541,17146.0,105,35,749.78,3,3,2,8,Gold
3542,17147.0,22,85,1679.64,2,2,1,5,Platinum
3543,17148.0,51,9,124.88,3,4,4,11,Bronze
3544,17152.0,194,16,1503.5,4,4,2,10,Silver
3545,17153.0,24,14,213.77999999999997,2,4,4,10,Silver
3546,17154.0,75,23,329.34,3,3,3,9,Gold
3547,17155.0,17,20,251.69999999999993,2,3,4,9,Gold
3548,17157.0,7,15,306.54999999999995,1,4,3,8,Gold
3549,17158.0,32,67,1266.97,2,2,2,6,Diamond
3550,17159.0,21,102,1534.73,2,1,2,5,Platinum
3551,17160.0,31,229,3518.0299999999997,2,1,1,4,Platinum
3552,17162.0,28,105,1707.21,2,1,1,4,Platinum
3553,17163.0,21,5,293.1,2,4,3,9,Gold
3554,17164.0,32,145,2466.4,2,1,1,4,Platinum
3555,17165.0,284,10,158.68,4,4,4,12,Bronze
3556,17166.0,38,14,189.48999999999998,2,4,4,10,Silver
3557,17169.0,50,60,816.88,2,2,2,6,Diamond
3558,17171.0,289,16,224.91,4,4,4,12,Bronze
3559,17172.0,74,16,313.26,3,4,3,10,Silver
3560,17173.0,5,87,3755.6499999999996,1,2,1,4,Platinum
3561,17174.0,217,4,59.9,4,4,4,12,Bronze
3562,17175.0,44,64,1430.94,2,2,2,6,Diamond
3563,17176.0,201,15,306.13,4,4,3,11,Bronze
3564,17179.0,178,80,711.79,4,2,2,8,Gold
3565,17180.0,56,128,768.3199999999999,3,1,2,6,Diamond
3566,17181.0,57,23,239.91999999999996,3,3,4,10,Silver
3567,17183.0,7,76,3286.91,1,2,1,4,Platinum
3568,17186.0,46,2,144.0,2,4,4,10,Silver
3569,17187.0,226,10,203.95,4,4,4,12,Bronze
3570,17188.0,11,89,2275.58,1,2,1,4,Platinum
3571,17189.0,106,60,383.75000000000006,3,2,3,8,Gold
3572,17190.0,58,20,249.74,3,3,4,10,Silver
3573,17191.0,28,236,2093.68,2,1,1,4,Platinum
3574,17193.0,35,35,1674.46,2,3,1,6,Diamond
3575,17194.0,273,29,262.62,4,3,4,11,Bronze
3576,17197.0,29,29,1013.01,2,3,2,7,Diamond
3577,17198.0,23,96,692.2199999999999,2,2,2,6,Diamond
3578,17201.0,53,38,289.78000000000003,3,3,4,10,Silver
3579,17203.0,35,148,3560.08,2,1,1,4,Platinum
3580,17204.0,169,67,1352.9100000000003,4,2,2,8,Gold
3581,17205.0,53,13,384.08,3,4,3,10,Silver
3582,17206.0,53,7,204.24,3,4,4,11,Bronze
3583,17211.0,26,213,2299.67,2,1,1,4,Platinum
3584,17212.0,253,4,226.85,4,4,4,12,Bronze
3585,17213.0,40,164,2741.08,2,1,1,4,Platinum
3586,17214.0,60,102,974.1199999999999,3,1,2,6,Diamond
3587,17217.0,234,9,113.49999999999999,4,4,4,12,Bronze
3588,17218.0,4,271,1951.97,1,1,1,3,Platinum
3589,17219.0,31,25,114.23,2,3,4,9,Gold
3590,17220.0,24,467,3187.5499999999997,2,1,1,4,Platinum
3591,17221.0,7,62,334.48,1,2,3,6,Diamond
3592,17222.0,65,27,328.65,3,3,3,9,Gold
3593,17223.0,310,48,416.89,4,2,3,9,Gold
3594,17226.0,308,21,393.48999999999995,4,3,3,10,Silver
3595,17227.0,18,47,939.3199999999999,2,2,2,6,Diamond
3596,17228.0,15,208,1906.09,1,1,1,3,Platinum
3597,17229.0,96,47,318.76000000000005,3,2,3,8,Gold
3598,17230.0,264,73,3466.67,4,2,1,7,Diamond
3599,17231.0,12,536,3078.22,1,1,1,3,Platinum
3600,17232.0,2,35,417.77,1,3,3,7,Diamond
3601,17233.0,35,25,190.88,2,3,4,9,Gold
3602,17234.0,182,14,149.89,4,4,4,12,Bronze
3603,17235.0,25,29,550.0600000000002,2,3,3,8,Gold
3604,17236.0,12,105,916.1300000000001,1,1,2,4,Platinum
3605,17237.0,11,19,314.69,1,3,3,7,Diamond
3606,17238.0,2,555,3719.1000000000004,1,1,1,3,Platinum
3607,17239.0,312,16,379.95000000000005,4,4,3,11,Bronze
3608,17242.0,108,40,1135.04,3,3,2,8,Gold
3609,17243.0,1,394,8491.75,1,1,1,3,Platinum
3610,17244.0,53,31,954.9,3,3,2,8,Gold
3611,17245.0,204,9,171.45,4,4,4,12,Bronze
3612,17247.0,15,54,280.09000000000003,1,2,4,7,Diamond
3613,17248.0,120,69,318.65000000000003,3,2,3,8,Gold
3614,17250.0,3,56,381.97,1,2,3,6,Diamond
3615,17251.0,362,37,269.83000000000004,4,3,4,11,Bronze
3616,17252.0,116,86,348.90999999999997,3,2,3,8,Gold
3617,17253.0,18,18,178.26,2,3,4,9,Gold
3618,17254.0,4,111,271.19,1,1,4,6,Diamond
3619,17255.0,40,74,291.47999999999996,2,2,4,8,Gold
3620,17256.0,107,16,240.0,3,4,4,11,Bronze
3621,17259.0,148,116,581.2299999999999,4,1,3,8,Gold
3622,17262.0,52,12,1253.3600000000001,3,4,2,9,Gold
3623,17263.0,208,23,63.440000000000005,4,3,4,11,Bronze
3624,17265.0,138,122,550.0100000000001,3,1,3,7,Diamond
3625,17266.0,2,73,296.58,1,2,3,6,Diamond
3626,17267.0,127,37,317.2,3,3,3,9,Gold
3627,17268.0,107,6,763.64,3,4,2,9,Gold
3628,17272.0,42,116,2144.53,2,1,1,4,Platinum
3629,17274.0,35,25,107.82,2,3,4,9,Gold
3630,17277.0,227,69,1065.3500000000001,4,2,2,8,Gold
3631,17278.0,241,15,246.04000000000002,4,4,4,12,Bronze
3632,17279.0,57,9,187.82999999999998,3,4,4,11,Bronze
3633,17282.0,130,89,1685.46,3,2,1,6,Diamond
3634,17284.0,60,293,1636.58,3,1,1,5,Platinum
3635,17286.0,21,44,151.37,2,2,4,8,Gold
3636,17287.0,26,122,1049.0600000000002,2,1,2,5,Platinum
3637,17288.0,9,140,1417.63,1,1,2,4,Platinum
3638,17289.0,31,105,922.77,2,1,2,5,Platinum
3639,17290.0,3,96,513.01,1,2,3,6,Diamond
3640,17291.0,308,1,550.8000000000001,4,4,3,11,Bronze
3641,17293.0,8,132,1854.06,1,1,1,3,Platinum
3642,17295.0,28,68,547.0,2,2,3,7,Diamond
3643,17297.0,17,49,128.18,2,2,4,8,Gold
3644,17298.0,101,30,498.42,3,3,3,9,Gold
3645,17299.0,11,55,656.61,1,2,2,5,Platinum
3646,17301.0,21,59,163.24,2,2,4,8,Gold
3647,17302.0,14,81,1119.9299999999998,1,2,2,5,Platinum
3648,17303.0,361,53,250.03999999999996,4,2,4,10,Silver
3649,17306.0,10,69,8600.730000000001,1,2,1,4,Platinum
3650,17307.0,365,1,-152.64000000000001,4,4,4,12,Bronze
3651,17309.0,95,12,82.75,3,4,4,11,Bronze
3652,17311.0,78,55,1384.85,3,2,2,7,Diamond
3653,17312.0,138,14,644.3,3,4,2,9,Gold
3654,17313.0,17,28,2288.13,2,3,1,6,Diamond
3655,17314.0,24,136,2514.76,2,1,1,4,Platinum
3656,17315.0,0,485,6193.43,1,1,1,3,Platinum
3657,17317.0,46,11,2524.0200000000004,2,4,1,7,Diamond
3658,17320.0,100,73,1200.6200000000001,3,2,2,7,Diamond
3659,17321.0,8,99,657.16,1,2,2,5,Platinum
3660,17323.0,15,199,894.44,1,1,2,4,Platinum
3661,17324.0,17,49,986.4799999999999,2,2,2,6,Diamond
3662,17325.0,280,6,96.8,4,4,4,12,Bronze
3663,17329.0,14,33,523.11,1,3,3,7,Diamond
3664,17330.0,22,6,363.9,2,4,3,9,Gold
3665,17331.0,123,1,175.2,3,4,4,11,Bronze
3666,17333.0,85,28,494.25,3,3,3,9,Gold
3667,17334.0,301,12,306.6,4,4,3,11,Bronze
3668,17337.0,151,526,1897.5099999999998,4,1,1,6,Diamond
3669,17338.0,17,725,6461.79,2,1,1,4,Platinum
3670,17339.0,94,9,243.36,3,4,4,11,Bronze
3671,17340.0,9,424,11891.18,1,1,1,3,Platinum
3672,17341.0,156,157,682.29,4,1,2,7,Diamond
3673,17343.0,355,17,193.64,4,4,4,12,Bronze
3674,17344.0,46,31,157.61999999999998,2,3,4,9,Gold
3675,17345.0,15,83,519.69,1,2,3,6,Diamond
3676,17346.0,3,486,2557.9000000000005,1,1,1,3,Platinum
3677,17347.0,86,1,228.96,3,4,4,11,Bronze
3678,17348.0,14,213,1156.6,1,1,2,4,Platinum
3679,17349.0,179,8,98.25,4,4,4,12,Bronze
3680,17350.0,8,71,1251.4400000000003,1,2,2,5,Platinum
3681,17351.0,36,27,587.15,2,3,3,8,Gold
3682,17353.0,129,8,1740.0,3,4,1,8,Gold
3683,17354.0,50,16,1393.06,2,4,2,8,Gold
3684,17356.0,311,19,178.21999999999997,4,3,4,11,Bronze
3685,17357.0,24,44,384.39,2,2,3,7,Diamond
3686,17358.0,303,58,360.80999999999995,4,2,3,9,Gold
3687,17359.0,11,15,127.85999999999999,1,4,4,9,Gold
3688,17360.0,17,125,568.2400000000001,2,1,3,6,Diamond
3689,17361.0,49,29,488.20000000000005,2,3,3,8,Gold
3690,17362.0,239,35,312.22999999999996,4,3,3,10,Silver
3691,17364.0,0,409,4437.23,1,1,1,3,Platinum
3692,17365.0,12,465,4767.360000000001,1,1,1,3,Platinum
3693,17367.0,238,33,167.54999999999998,4,3,4,11,Bronze
3694,17368.0,23,124,1315.72,2,1,2,5,Platinum
3695,17370.0,72,33,446.17999999999995,3,3,3,9,Gold
3696,17371.0,17,86,418.40000000000003,2,2,3,7,Diamond
3697,17372.0,40,251,1337.18,2,1,2,5,Platinum
3698,17373.0,40,57,646.9200000000001,2,2,2,6,Diamond
3699,17374.0,218,28,495.7699999999999,4,3,3,10,Silver
3700,17375.0,190,71,372.49999999999994,4,2,3,9,Gold
3701,17376.0,70,24,203.2,3,3,4,10,Silver
3702,17377.0,23,405,3883.3199999999997,2,1,1,4,Platinum
3703,17379.0,11,78,389.72,1,2,3,6,Diamond
3704,17381.0,8,110,20272.43,1,1,1,3,Platinum
3705,17382.0,65,2,65.4,3,4,4,11,Bronze
3706,17383.0,4,49,193.39,1,2,4,7,Diamond
3707,17384.0,19,15,336.4,2,4,3,9,Gold
3708,17385.0,14,45,256.11,1,2,4,7,Diamond
3709,17386.0,7,28,2686.4200000000005,1,3,1,5,Platinum
3710,17387.0,19,76,746.81,2,2,2,6,Diamond
3711,17388.0,77,15,1259.5600000000002,3,4,2,9,Gold
3712,17389.0,0,224,31300.079999999998,1,1,1,3,Platinum
3713,17391.0,163,3,508.8,4,4,3,11,Bronze
3714,17392.0,306,56,417.27,4,2,3,9,Gold
3715,17394.0,219,4,203.86999999999995,4,4,4,12,Bronze
3716,17396.0,39,27,7330.8,2,3,1,6,Diamond
3717,17397.0,22,89,681.41,2,2,2,6,Diamond
3718,17398.0,114,38,653.38,3,3,2,8,Gold
3719,17400.0,126,206,2097.84,3,1,1,5,Platinum
3720,17402.0,4,59,2633.8499999999995,1,2,1,4,Platinum
3721,17403.0,36,32,263.92,2,3,4,9,Gold
3722,17404.0,4,201,30300.82,1,1,1,3,Platinum
3723,17405.0,1,94,967.2199999999998,1,2,2,5,Platinum
3724,17406.0,330,114,1912.7199999999998,4,1,1,6,Diamond
3725,17408.0,163,2,32.65,4,4,4,12,Bronze
3726,17409.0,184,13,771.8499999999999,4,4,2,10,Silver
3727,17410.0,16,64,1214.72,1,2,2,5,Platinum
3728,17411.0,12,43,748.94,1,2,2,5,Platinum
3729,17412.0,2,66,1258.0600000000002,1,2,2,5,Platinum
3730,17414.0,43,6,778.0,2,4,2,8,Gold
3731,17415.0,79,14,507.8399999999999,3,4,3,10,Silver
3732,17416.0,29,271,6838.34,2,1,1,4,Platinum
3733,17418.0,42,30,463.46,2,3,3,8,Gold
3734,17419.0,11,208,4200.97,1,1,1,3,Platinum
3735,17420.0,50,30,598.83,2,3,3,8,Gold
3736,17422.0,16,135,1853.1299999999997,1,1,1,3,Platinum
3737,17423.0,45,28,663.63,2,3,2,7,Diamond
3738,17425.0,19,43,759.1700000000001,2,2,2,6,Diamond
3739,17426.0,4,272,5022.26,1,1,1,3,Platinum
3740,17427.0,71,2,100.8,3,4,4,11,Bronze
3741,17428.0,0,343,17078.449999999997,1,1,1,3,Platinum
3742,17429.0,120,42,512.12,3,2,3,8,Gold
3743,17430.0,32,14,265.76000000000005,2,4,4,10,Silver
3744,17431.0,313,43,403.3,4,2,3,9,Gold
3745,17432.0,18,48,365.76,2,2,3,7,Diamond
3746,17433.0,88,54,303.15999999999997,3,2,3,8,Gold
3747,17434.0,2,138,2333.42,1,1,1,3,Platinum
3748,17436.0,1,9,216.3,1,4,4,9,Gold
3749,17438.0,247,19,378.30000000000007,4,3,3,10,Silver
3750,17440.0,147,8,177.1,4,4,4,12,Bronze
3751,17442.0,29,140,2210.2599999999998,2,1,1,4,Platinum
3752,17443.0,219,1,534.24,4,4,3,11,Bronze
3753,17444.0,147,135,2940.04,4,1,1,6,Diamond
3754,17446.0,176,9,120.90000000000002,4,4,4,12,Bronze
3755,17447.0,40,36,541.53,2,3,3,8,Gold
3756,17448.0,144,1,-4287.63,4,4,4,12,Bronze
3757,17449.0,2,278,2503.2100000000005,1,1,1,3,Platinum
3758,17450.0,8,350,187322.17,1,1,1,3,Platinum
3759,17451.0,1,107,1648.95,1,1,1,3,Platinum
3760,17453.0,17,19,486.71999999999997,2,3,3,8,Gold
3761,17454.0,192,61,517.53,4,2,3,9,Gold
3762,17455.0,203,8,131.7,4,4,4,12,Bronze
3763,17456.0,365,17,249.86,4,4,4,12,Bronze
3764,17457.0,126,19,1737.7,3,3,1,7,Diamond
3765,17458.0,15,54,316.49999999999994,1,2,3,6,Diamond
3766,17459.0,43,111,657.3,2,1,2,5,Platinum
3767,17460.0,78,37,452.63000000000005,3,3,3,9,Gold
3768,17461.0,22,106,735.82,2,1,2,5,Platinum
3769,17462.0,51,28,662.9399999999999,3,3,2,8,Gold
3770,17463.0,16,212,1860.81,1,1,1,3,Platinum
3771,17464.0,158,9,289.96000000000004,4,4,4,12,Bronze
3772,17466.0,10,41,763.28,1,3,2,6,Diamond
3773,17468.0,10,5,137.0,1,4,4,9,Gold
3774,17469.0,16,90,1843.06,1,2,1,4,Platinum
3775,17470.0,44,78,1125.0700000000002,2,2,2,6,Diamond
3776,17472.0,191,174,697.5400000000001,4,1,2,7,Diamond
3777,17475.0,79,14,194.36999999999995,3,4,4,11,Bronze
3778,17480.0,73,31,506.51,3,3,3,9,Gold
3779,17481.0,3,83,1249.3400000000001,1,2,2,5,Platinum
3780,17483.0,65,21,414.04,3,3,3,9,Gold
3781,17486.0,261,24,396.87,4,3,3,10,Silver
3782,17489.0,58,29,376.63999999999993,3,3,3,9,Gold
3783,17490.0,0,86,1926.88,1,2,1,4,Platinum
3784,17491.0,1,110,3541.920000000001,1,1,1,3,Platinum
3785,17492.0,248,12,374.57,4,4,3,11,Bronze
3786,17495.0,7,27,497.56000000000006,1,3,3,7,Diamond
3787,17496.0,358,10,271.05,4,4,4,12,Bronze
3788,17498.0,75,17,272.22,3,4,4,11,Bronze
3789,17499.0,289,40,622.88,4,3,3,10,Silver
3790,17500.0,17,5,1138.0,2,4,2,8,Gold
3791,17501.0,220,18,288.59999999999997,4,3,4,11,Bronze
3792,17502.0,9,28,689.0999999999999,1,3,2,6,Diamond
3793,17503.0,2,38,558.9599999999999,1,3,3,7,Diamond
3794,17504.0,206,140,2745.2799999999997,4,1,1,6,Diamond
3795,17505.0,161,52,1145.84,4,2,2,8,Gold
3796,17506.0,70,16,294.29,3,4,3,10,Silver
3797,17507.0,261,88,605.58,4,2,3,9,Gold
3798,17508.0,280,22,387.31,4,3,3,10,Silver
3799,17509.0,57,367,6069.24,3,1,1,5,Platinum
3800,17510.0,24,20,308.48,2,3,3,8,Gold
3801,17511.0,2,1076,88125.38,1,1,1,3,Platinum
3802,17512.0,28,106,2920.04,2,1,1,4,Platinum
3803,17513.0,72,6,513.2,3,4,3,10,Silver
3804,17514.0,128,40,208.65,3,3,4,10,Silver
3805,17515.0,31,87,639.02,2,2,3,7,Diamond
3806,17516.0,15,135,764.8799999999999,1,1,2,4,Platinum
3807,17517.0,308,11,153.94,4,4,4,12,Bronze
3808,17519.0,17,83,1839.07,2,2,1,5,Platinum
3809,17520.0,53,30,546.81,3,3,3,9,Gold
3810,17521.0,24,46,721.96,2,2,2,6,Diamond
3811,17522.0,1,73,1070.71,1,2,2,5,Platinum
3812,17523.0,11,33,652.74,1,3,2,6,Diamond
3813,17524.0,361,6,145.0,4,4,4,12,Bronze
3814,17525.0,359,9,422.7,4,4,3,11,Bronze
3815,17526.0,1,23,706.7,1,3,2,6,Diamond
3816,17527.0,53,49,888.86,3,2,2,7,Diamond
3817,17528.0,1,260,3540.0999999999995,1,1,1,3,Platinum
3818,17530.0,1,390,2367.12,1,1,1,3,Platinum
3819,17531.0,120,15,293.45,3,4,3,10,Silver
3820,17534.0,53,9,223.36,3,4,4,11,Bronze
3821,17535.0,280,13,164.39999999999998,4,4,4,12,Bronze
3822,17536.0,177,3,76.5,4,4,4,12,Bronze
3823,17537.0,29,74,887.67,2,2,2,6,Diamond
3824,17538.0,25,9,98.42,2,4,4,10,Silver
3825,17540.0,8,26,570.4,1,3,3,7,Diamond
3826,17542.0,269,25,170.75,4,3,4,11,Bronze
3827,17545.0,43,141,642.3199999999999,2,1,3,6,Diamond
3828,17547.0,372,2,-11.8,4,4,4,12,Bronze
3829,17548.0,217,17,-141.48,4,4,4,12,Bronze
3830,17549.0,23,6,148.86,2,4,4,10,Silver
3831,17550.0,197,42,267.1600000000001,4,2,4,10,Silver
3832,17551.0,359,39,290.34,4,3,4,11,Bronze
3833,17552.0,42,51,909.9599999999999,2,2,2,6,Diamond
3834,17553.0,129,2,1487.6,3,4,2,9,Gold
3835,17554.0,1,88,1952.4499999999998,1,2,1,4,Platinum
3836,17555.0,19,105,480.31,2,1,3,6,Diamond
3837,17556.0,205,6,157.9,4,4,4,12,Bronze
3838,17557.0,14,34,541.4599999999999,1,3,3,7,Diamond
3839,17560.0,94,27,854.9500000000002,3,3,2,8,Gold
3840,17561.0,19,45,165.11999999999998,2,2,4,8,Gold
3841,17562.0,14,64,1107.3799999999999,1,2,2,5,Platinum
3842,17564.0,24,49,454.01,2,2,3,7,Diamond
3843,17566.0,8,142,869.77,1,1,2,4,Platinum
3844,17567.0,7,177,4012.56,1,1,1,3,Platinum
3845,17569.0,332,29,344.13999999999993,4,3,3,10,Silver
3846,17571.0,50,271,1425.67,2,1,2,5,Platinum
3847,17572.0,71,12,226.75,3,4,4,11,Bronze
3848,17573.0,29,26,362.90000000000003,2,3,3,8,Gold
3849,17574.0,242,8,185.64999999999998,4,4,4,12,Bronze
3850,17576.0,8,408,3399.93,1,1,1,3,Platinum
3851,17578.0,190,6,124.73999999999998,4,4,4,12,Bronze
3852,17579.0,4,52,440.2,1,2,3,6,Diamond
3853,17580.0,252,45,215.71999999999997,4,2,4,10,Silver
3854,17581.0,0,451,10716.310000000001,1,1,1,3,Platinum
3855,17582.0,236,29,175.27,4,3,4,11,Bronze
3856,17584.0,7,36,1227.3000000000004,1,3,2,6,Diamond
3857,17585.0,109,208,1116.68,3,1,2,6,Diamond
3858,17588.0,100,23,1240.2,3,3,2,8,Gold
3859,17589.0,60,253,2404.17,3,1,1,5,Platinum
3860,17590.0,2,196,1468.02,1,1,2,4,Platinum
3861,17591.0,73,158,2192.7200000000003,3,1,1,5,Platinum
3862,17593.0,3,214,3908.0800000000004,1,1,1,3,Platinum
3863,17594.0,85,50,993.1800000000001,3,2,2,7,Diamond
3864,17595.0,12,82,386.69000000000005,1,2,3,6,Diamond
3865,17596.0,23,265,2806.69,2,1,1,4,Platinum
3866,17597.0,213,55,2044.37,4,2,1,7,Diamond
3867,17600.0,17,13,161.67000000000002,2,4,4,10,Silver
3868,17601.0,239,9,116.00999999999999,4,4,4,12,Bronze
3869,17602.0,2,556,5002.219999999999,1,1,1,3,Platinum
3870,17603.0,50,15,-1165.2999999999997,2,4,4,10,Silver
3871,17604.0,217,63,309.35999999999996,4,2,3,9,Gold
3872,17608.0,33,56,191.99,2,2,4,8,Gold
3873,17609.0,40,234,1097.48,2,1,2,5,Platinum
3874,17611.0,3,573,3924.77,1,1,1,3,Platinum
3875,17612.0,53,142,1992.7599999999998,3,1,1,5,Platinum
3876,17613.0,22,313,4494.77,2,1,1,4,Platinum
3877,17614.0,57,98,386.32,3,2,3,8,Gold
3878,17615.0,130,14,329.6000000000001,3,4,3,10,Silver
3879,17616.0,173,3,571.2,4,4,3,11,Bronze
3880,17618.0,5,67,930.2800000000001,1,2,2,5,Platinum
3881,17619.0,312,74,214.36999999999998,4,2,4,10,Silver
3882,17620.0,59,4,81.44,3,4,4,11,Bronze
3883,17621.0,21,27,1336.1,2,3,2,7,Diamond
3884,17623.0,32,33,527.0500000000001,2,3,3,8,Gold
3885,17624.0,14,50,843.48,1,2,2,5,Platinum
3886,17625.0,18,306,2020.4,2,1,1,4,Platinum
3887,17628.0,81,5,75.75000000000001,3,4,4,11,Bronze
3888,17629.0,5,124,1784.12,1,1,1,3,Platinum
3889,17630.0,169,26,503.59999999999997,4,3,3,10,Silver
3890,17631.0,1,39,528.3300000000002,1,3,3,7,Diamond
3891,17633.0,31,72,1242.3400000000001,2,2,2,6,Diamond
3892,17634.0,36,296,2358.59,2,1,1,4,Platinum
3893,17636.0,8,24,265.93,1,3,4,8,Gold
3894,17637.0,31,35,547.0600000000001,2,3,3,8,Gold
3895,17639.0,276,7,108.5,4,4,4,12,Bronze
3896,17640.0,86,5,621.6600000000001,3,4,3,10,Silver
3897,17642.0,119,40,712.29,3,3,2,8,Gold
3898,17643.0,373,8,101.55,4,4,4,12,Bronze
3899,17644.0,1,169,2768.9799999999996,1,1,1,3,Platinum
3900,17646.0,219,54,995.66,4,2,2,8,Gold
3901,17647.0,65,7,133.06,3,4,4,11,Bronze
3902,17648.0,60,92,1789.5500000000002,3,2,1,6,Diamond
3903,17649.0,134,53,861.74,3,2,2,7,Diamond
3904,17650.0,21,8,166.07999999999998,2,4,4,10,Silver
3905,17651.0,11,239,3886.67,1,1,1,3,Platinum
3906,17652.0,25,270,4737.13,2,1,1,4,Platinum
3907,17653.0,29,50,1175.88,2,2,2,6,Diamond
3908,17654.0,277,22,117.55000000000001,4,3,4,11,Bronze
3909,17655.0,10,93,2571.7400000000007,1,2,1,4,Platinum
3910,17656.0,73,82,1674.6900000000003,3,2,1,6,Diamond
3911,17658.0,10,23,485.87999999999994,1,3,3,7,Diamond
3912,17659.0,3,161,2954.75,1,1,1,3,Platinum
3913,17660.0,141,38,178.75000000000003,3,3,4,10,Silver
3914,17663.0,25,90,1788.2700000000004,2,2,1,5,Platinum
3915,17664.0,18,43,604.64,2,2,3,7,Diamond
3916,17666.0,3,18,728.1599999999999,1,3,2,6,Diamond
3917,17667.0,66,117,2055.51,3,1,1,5,Platinum
3918,17668.0,1,15,347.75,1,4,3,8,Gold
3919,17669.0,42,68,3406.72,2,2,1,5,Platinum
3920,17670.0,227,11,205.7,4,4,4,12,Bronze
3921,17671.0,15,61,1284.0800000000002,1,2,2,5,Platinum
3922,17672.0,43,115,3106.62,2,1,1,4,Platinum
3923,17673.0,1,219,1588.07,1,1,2,4,Platinum
3924,17674.0,74,27,551.0400000000001,3,3,3,9,Gold
3925,17675.0,1,721,20098.1,1,1,1,3,Platinum
3926,17676.0,4,78,1366.7700000000002,1,2,2,5,Platinum
3927,17677.0,1,320,16201.369999999999,1,1,1,3,Platinum
3928,17678.0,263,16,298.11,4,4,3,11,Bronze
3929,17679.0,52,30,1992.1100000000001,3,3,1,7,Diamond
3930,17680.0,23,11,184.39999999999998,2,4,4,10,Silver
3931,17682.0,10,119,2459.3299999999995,1,1,1,3,Platinum
3932,17684.0,43,15,239.41,2,4,4,10,Silver
3933,17685.0,16,127,3155.8299999999995,1,1,1,3,Platinum
3934,17686.0,7,286,5739.460000000001,1,1,1,3,Platinum
3935,17690.0,30,254,4717.3,2,1,1,4,Platinum
3936,17691.0,358,19,290.4,4,3,4,11,Bronze
3937,17692.0,127,47,733.4399999999998,3,2,2,7,Diamond
3938,17693.0,136,18,187.01999999999998,3,3,4,10,Silver
3939,17694.0,141,15,283.12,3,4,4,11,Bronze
3940,17695.0,131,35,765.3400000000001,3,3,2,8,Gold
3941,17696.0,38,126,2201.05,2,1,1,4,Platinum
3942,17697.0,236,19,338.95000000000005,4,3,3,10,Silver
3943,17698.0,260,8,154.95,4,4,4,12,Bronze
3944,17700.0,16,146,2508.89,1,1,1,3,Platinum
3945,17701.0,252,24,417.95000000000005,4,3,3,10,Silver
3946,17702.0,30,80,1719.7200000000003,2,2,1,5,Platinum
3947,17703.0,35,55,798.74,2,2,2,6,Diamond
3948,17704.0,168,31,885.1899999999999,4,3,2,9,Gold
3949,17705.0,3,108,1781.12,1,1,1,3,Platinum
3950,17706.0,4,395,10097.37,1,1,1,3,Platinum
3951,17707.0,185,5,152.39999999999998,4,4,4,12,Bronze
3952,17708.0,187,34,263.33,4,3,4,11,Bronze
3953,17709.0,169,7,137.45,4,4,4,12,Bronze
3954,17711.0,10,23,385.1,1,3,3,7,Diamond
3955,17712.0,44,29,522.91,2,3,3,8,Gold
3956,17714.0,320,10,153.0,4,4,4,12,Bronze
3957,17715.0,200,1,326.4,4,4,3,11,Bronze
3958,17716.0,22,254,5505.79,2,1,1,4,Platinum
3959,17718.0,232,6,139.35,4,4,4,12,Bronze
3960,17719.0,37,278,5367.8,2,1,1,4,Platinum
3961,17720.0,26,50,1195.94,2,2,2,6,Diamond
3962,17722.0,96,120,2380.6400000000003,3,1,1,5,Platinum
3963,17723.0,127,10,3276.4,3,4,1,8,Gold
3964,17724.0,57,45,995.65,3,2,2,7,Diamond
3965,17725.0,16,198,3371.13,1,1,1,3,Platinum
3966,17727.0,9,67,1042.55,1,2,2,5,Platinum
3967,17728.0,3,169,2515.6800000000003,1,1,1,3,Platinum
3968,17730.0,3,220,5288.83,1,1,1,3,Platinum
3969,17731.0,79,83,878.2000000000002,3,2,2,7,Diamond
3970,17732.0,372,18,303.96999999999997,4,3,3,10,Silver
3971,17733.0,38,35,692.1899999999999,2,3,2,7,Diamond
3972,17734.0,53,43,700.63,3,2,2,7,Diamond
3973,17735.0,2,690,13110.02,1,1,1,3,Platinum
3974,17736.0,9,26,337.49,1,3,3,7,Diamond
3975,17737.0,9,10,168.24,1,4,4,9,Gold
3976,17738.0,19,99,1863.35,2,2,1,5,Platinum
3977,17739.0,11,48,2786.0499999999997,1,2,1,4,Platinum
3978,17742.0,113,15,355.11,3,4,3,10,Silver
3979,17744.0,3,137,2291.08,1,1,1,3,Platinum
3980,17746.0,234,8,98.80000000000001,4,4,4,12,Bronze
3981,17747.0,100,2,64.65,3,4,4,11,Bronze
3982,17749.0,178,35,674.52,4,3,2,9,Gold
3983,17750.0,5,184,1710.4499999999998,1,1,1,3,Platinum
3984,17752.0,359,1,80.64,4,4,4,12,Bronze
3985,17754.0,0,90,1632.31,1,2,1,4,Platinum
3986,17757.0,1,741,5573.59,1,1,1,3,Platinum
3987,17758.0,19,404,3408.2000000000003,2,1,1,4,Platinum
3988,17759.0,17,90,819.96,2,2,2,6,Diamond
3989,17760.0,21,25,287.59000000000003,2,3,4,9,Gold
3990,17761.0,32,19,712.78,2,3,2,7,Diamond
3991,17763.0,263,1,15.0,4,4,4,12,Bronze
3992,17764.0,50,71,772.5500000000001,2,2,2,6,Diamond
3993,17765.0,158,56,367.63,4,2,3,9,Gold
3994,17767.0,15,21,271.20000000000005,1,3,4,8,Gold
3995,17768.0,8,98,2081.9,1,2,1,4,Platinum
3996,17769.0,12,307,3920.08,1,1,1,3,Platinum
3997,17770.0,198,38,1143.2699999999998,4,3,2,9,Gold
3998,17771.0,56,54,245.81000000000003,3,2,4,9,Gold
3999,17772.0,10,50,173.45,1,2,4,7,Diamond
4000,17774.0,96,154,1203.78,3,1,2,6,Diamond
4001,17775.0,254,3,56.4,4,4,4,12,Bronze
4002,17777.0,24,190,647.56,2,1,2,5,Platinum
4003,17779.0,21,83,633.9200000000001,2,2,3,7,Diamond
4004,17781.0,159,12,188.01999999999998,4,4,4,12,Bronze
4005,17783.0,72,67,283.4699999999999,3,2,4,9,Gold
4006,17785.0,53,13,131.94,3,4,4,11,Bronze
4007,17786.0,85,68,266.8500000000001,3,2,4,9,Gold
4008,17787.0,152,128,1817.54,4,1,1,6,Diamond
4009,17788.0,73,5,1117.9,3,4,2,9,Gold
4010,17789.0,281,14,225.9,4,4,4,12,Bronze
4011,17790.0,26,189,1964.3000000000002,2,1,1,4,Platinum
4012,17791.0,29,10,106.1,2,4,4,10,Silver
4013,17793.0,25,52,300.34,2,2,3,7,Diamond
4014,17795.0,179,45,342.82999999999987,4,2,3,9,Gold
4015,17796.0,40,81,690.0,2,2,2,6,Diamond
4016,17797.0,22,111,780.4300000000002,2,1,2,5,Platinum
4017,17799.0,22,406,3009.32,2,1,1,4,Platinum
4018,17800.0,37,103,1187.21,2,1,2,5,Platinum
4019,17802.0,82,147,1251.8400000000001,3,1,2,6,Diamond
4020,17805.0,73,10,512.31,3,4,3,10,Silver
4021,17806.0,11,43,546.04,1,2,3,6,Diamond
4022,17809.0,16,64,4627.62,1,2,1,4,Platinum
4023,17811.0,4,849,7601.8,1,1,1,3,Platinum
4024,17812.0,12,133,699.81,1,1,2,4,Platinum
4025,17813.0,14,355,1641.79,1,1,1,3,Platinum
4026,17816.0,36,17,36.559999999999995,2,4,4,10,Silver
4027,17817.0,4,33,387.68,1,3,3,7,Diamond
4028,17819.0,71,49,3661.0699999999997,3,2,1,6,Diamond
4029,17820.0,191,5,-24.049999999999997,4,4,4,12,Bronze
4030,17824.0,51,13,298.4,3,4,3,10,Silver
4031,17827.0,5,215,1987.33,1,1,1,3,Platinum
4032,17828.0,8,82,1599.9700000000003,1,2,2,5,Platinum
4033,17829.0,298,30,889.24,4,3,2,9,Gold
4034,17830.0,1,23,398.69999999999993,1,3,3,7,Diamond
4035,17831.0,33,2,35.400000000000006,2,4,4,10,Silver
4036,17832.0,49,61,155.37000000000003,2,2,4,8,Gold
4037,17835.0,2,59,342.23999999999995,1,2,3,6,Diamond
4038,17836.0,47,24,110.21,2,3,4,9,Gold
4039,17837.0,42,165,1508.38,2,1,2,5,Platinum
4040,17838.0,26,132,2267.4,2,1,1,4,Platinum
4041,17839.0,42,52,318.15000000000003,2,2,3,7,Diamond
4042,17841.0,1,7812,39869.05,1,1,1,3,Platinum
4043,17843.0,303,37,205.48000000000002,4,3,4,11,Bronze
4044,17844.0,106,5,51.56,3,4,4,11,Bronze
4045,17846.0,85,1,2033.1,3,4,1,8,Gold
4046,17848.0,81,51,901.2,3,2,2,7,Diamond
4047,17849.0,218,26,605.8000000000001,4,3,3,10,Silver
4048,17850.0,302,309,5303.4800000000005,4,1,1,6,Diamond
4049,17852.0,11,24,114.34,1,3,4,8,Gold
4050,17854.0,185,15,311.26,4,4,3,11,Bronze
4051,17855.0,372,17,208.97,4,4,4,12,Bronze
4052,17856.0,1,17,1393.79,1,4,2,7,Diamond
4053,17857.0,3,56,26763.34,1,2,1,4,Platinum
4054,17858.0,5,197,5140.66,1,1,1,3,Platinum
4055,17859.0,304,23,141.92000000000002,4,3,4,11,Bronze
4056,17860.0,368,52,226.45,4,2,4,10,Silver
4057,17861.0,3,220,2056.2799999999997,1,1,1,3,Platinum
4058,17862.0,323,11,330.9,4,4,3,11,Bronze
4059,17863.0,59,148,3160.0,3,1,1,5,Platinum
4060,17864.0,12,90,554.85,1,2,3,6,Diamond
4061,17865.0,30,389,10158.54,2,1,1,4,Platinum
4062,17866.0,142,10,325.7,3,4,3,10,Silver
4063,17867.0,30,70,583.5200000000003,2,2,3,7,Diamond
4064,17869.0,107,40,428.18,3,3,3,9,Gold
4065,17870.0,2,271,1860.94,1,1,1,3,Platinum
4066,17871.0,204,10,155.90000000000003,4,4,4,12,Bronze
4067,17873.0,80,45,1754.1600000000005,3,2,1,6,Diamond
4068,17874.0,185,47,658.2600000000001,4,2,2,8,Gold
4069,17877.0,170,12,237.61,4,4,4,12,Bronze
4070,17878.0,43,26,379.45,2,3,3,8,Gold
4071,17879.0,173,6,178.51999999999998,4,4,4,12,Bronze
4072,17880.0,364,26,458.91999999999996,4,3,3,10,Silver
4073,17881.0,304,8,133.35000000000002,4,4,4,12,Bronze
4074,17883.0,3,142,664.34,1,1,2,4,Platinum
4075,17884.0,3,113,695.07,1,1,2,4,Platinum
4076,17885.0,12,53,156.34,1,2,4,7,Diamond
4077,17886.0,31,102,869.28,2,1,2,5,Platinum
4078,17887.0,129,10,111.35,3,4,4,11,Bronze
4079,17888.0,18,79,515.73,2,2,3,7,Diamond
4080,17889.0,212,20,201.37,4,3,4,11,Bronze
4081,17890.0,322,91,586.8900000000001,4,2,3,9,Gold
4082,17891.0,162,34,203.85999999999996,4,3,4,11,Bronze
4083,17892.0,56,28,244.10000000000002,3,3,4,10,Silver
4084,17893.0,225,15,107.21000000000002,4,4,4,12,Bronze
4085,17894.0,71,192,1118.96,3,1,2,6,Diamond
4086,17895.0,44,15,95.44999999999999,2,4,4,10,Silver
4087,17896.0,23,2,256.32,2,4,4,10,Silver
4088,17897.0,172,109,516.3100000000001,4,1,3,8,Gold
4089,17898.0,85,28,152.06,3,3,4,10,Silver
4090,17899.0,159,31,154.55,4,3,4,11,Bronze
4091,17900.0,164,11,15.0,4,4,4,12,Bronze
4092,17901.0,29,19,110.38,2,3,4,9,Gold
4093,17904.0,21,35,168.32,2,3,4,9,Gold
4094,17905.0,71,33,798.99,3,3,2,8,Gold
4095,17906.0,247,12,72.9,4,4,4,12,Bronze
4096,17908.0,373,54,232.02999999999994,4,2,4,10,Silver
4097,17911.0,9,39,366.23,1,3,3,7,Diamond
4098,17912.0,310,39,294.66,4,3,3,10,Silver
4099,17913.0,58,58,408.65,3,2,3,8,Gold
4100,17914.0,3,75,329.35999999999996,1,2,3,6,Diamond
4101,17917.0,45,92,335.03000000000003,2,2,3,7,Diamond
4102,17919.0,88,23,1304.0400000000002,3,3,2,8,Gold
4103,17920.0,4,665,4119.5,1,1,1,3,Platinum
4104,17921.0,64,142,820.2299999999999,3,1,2,6,Diamond
4105,17923.0,282,1,207.50000000000003,4,4,4,12,Bronze
4106,17924.0,1,38,2894.33,1,3,1,5,Platinum
4107,17925.0,372,1,244.08,4,4,4,12,Bronze
4108,17926.0,133,21,397.29,3,3,3,9,Gold
4109,17928.0,45,23,212.54000000000002,2,3,4,9,Gold
4110,17929.0,11,6,834.5,1,4,2,7,Diamond
4111,17930.0,35,39,1740.4799999999998,2,3,1,6,Diamond
4112,17931.0,134,65,408.36,3,2,3,8,Gold
4113,17932.0,29,90,1331.57,2,2,2,6,Diamond
4114,17934.0,51,21,704.25,3,3,2,8,Gold
4115,17935.0,138,29,145.79000000000002,3,3,4,10,Silver
4116,17936.0,5,72,380.13,1,2,3,6,Diamond
4117,17937.0,8,43,4301.22,1,2,1,4,Platinum
4118,17939.0,159,12,99.14000000000001,4,4,4,12,Bronze
4119,17940.0,49,22,1897.18,2,3,1,6,Diamond
4120,17941.0,130,2,304.56,3,4,3,10,Silver
4121,17942.0,7,2,77.50000000000001,1,4,4,9,Gold
4122,17946.0,233,20,149.58,4,3,4,11,Bronze
4123,17947.0,37,9,176.67999999999998,2,4,4,10,Silver
4124,17948.0,147,1,358.56000000000006,4,4,3,11,Bronze
4125,17949.0,1,79,52750.840000000004,1,2,1,4,Platinum
4126,17950.0,72,72,472.12,3,2,3,8,Gold
4127,17951.0,39,21,990.8400000000003,2,3,2,7,Diamond
4128,17954.0,5,481,2276.7799999999997,1,1,1,3,Platinum
4129,17955.0,198,19,557.3,4,3,3,10,Silver
4130,17956.0,249,1,12.75,4,4,4,12,Bronze
4131,17957.0,66,31,111.67999999999999,3,3,4,10,Silver
4132,17958.0,116,7,508.4599999999999,3,4,3,10,Silver
4133,17960.0,171,26,73.78,4,3,4,11,Bronze
4134,17961.0,21,249,1296.44,2,1,2,5,Platinum
4135,17962.0,142,34,102.41,3,3,4,10,Silver
4136,17964.0,31,98,463.21,2,2,3,7,Diamond
4137,17965.0,37,325,2599.1899999999996,2,1,1,4,Platinum
4138,17966.0,37,68,1098.4299999999998,2,2,2,6,Diamond
4139,17967.0,371,42,112.26999999999998,4,2,4,10,Silver
4140,17968.0,373,81,265.09999999999997,4,2,4,10,Silver
4141,17969.0,166,14,228.20000000000002,4,4,4,12,Bronze
4142,17970.0,211,29,562.7900000000001,4,3,3,10,Silver
4143,17972.0,241,30,135.19,4,3,4,11,Bronze
4144,17973.0,51,15,337.03999999999996,3,4,3,10,Silver
4145,17974.0,24,165,703.99,2,1,2,5,Platinum
4146,17975.0,15,294,4388.06,1,1,1,3,Platinum
4147,17976.0,372,57,321.78999999999996,4,2,3,9,Gold
4148,17977.0,29,21,288.14,2,3,4,9,Gold
4149,17978.0,365,12,300.91999999999996,4,4,3,11,Bronze
4150,17979.0,35,139,712.51,2,1,2,5,Platinum
4151,17980.0,165,30,811.45,4,3,2,9,Gold
4152,17984.0,145,48,152.68,4,2,4,10,Silver
4153,17985.0,22,21,631.3499999999999,2,3,3,8,Gold
4154,17986.0,56,1,20.8,3,4,4,11,Bronze
4155,17987.0,185,13,198.57,4,4,4,12,Bronze
4156,17988.0,11,39,191.17,1,3,4,8,Gold
4157,17990.0,236,29,630.84,4,3,3,10,Silver
4158,17991.0,225,5,93.35,4,4,4,12,Bronze
4159,17994.0,121,82,626.0899999999999,3,2,3,8,Gold
4160,17995.0,281,2,76.1,4,4,4,12,Bronze
4161,17997.0,74,178,1503.0900000000001,3,1,2,6,Diamond
4162,17999.0,37,91,380.39000000000004,2,2,3,7,Diamond
4163,18001.0,12,57,415.13,1,2,3,6,Diamond
4164,18004.0,362,37,157.91999999999996,4,3,4,11,Bronze
4165,18005.0,3,53,226.47,1,2,4,7,Diamond
4166,18006.0,23,22,444.68,2,3,3,8,Gold
4167,18008.0,70,30,2116.19,3,3,1,7,Diamond
4168,18009.0,235,32,242.29,4,3,4,11,Bronze
4169,18010.0,256,14,174.79999999999998,4,4,4,12,Bronze
4170,18011.0,373,28,102.79,4,3,4,11,Bronze
4171,18013.0,155,31,187.29,4,3,4,11,Bronze
4172,18014.0,28,30,162.22,2,3,4,9,Gold
4173,18015.0,4,46,120.03000000000002,1,2,4,7,Diamond
4174,18016.0,32,122,1477.66,2,1,2,5,Platinum
4175,18017.0,81,3,523.0,3,4,3,10,Silver
4176,18018.0,108,29,122.14,3,3,4,10,Silver
4177,18019.0,51,5,38.45,3,4,4,11,Bronze
4178,18022.0,35,164,612.72,2,1,3,6,Diamond
4179,18024.0,152,22,236.77999999999997,4,3,4,11,Bronze
4180,18027.0,98,21,115.30999999999999,3,3,4,10,Silver
4181,18030.0,4,10,220.7,1,4,4,9,Gold
4182,18032.0,334,5,73.5,4,4,4,12,Bronze
4183,18033.0,65,33,93.82000000000001,3,3,4,10,Silver
4184,18034.0,21,110,418.6799999999999,2,1,3,6,Diamond
4185,18035.0,35,49,713.8900000000001,2,2,2,6,Diamond
4186,18036.0,32,94,403.12000000000006,2,2,3,7,Diamond
4187,18037.0,154,19,70.02,4,3,4,11,Bronze
4188,18040.0,19,19,357.2,2,3,3,8,Gold
4189,18041.0,11,460,4075.12,1,1,1,3,Platinum
4190,18042.0,53,7,165.04999999999998,3,4,4,11,Bronze
4191,18043.0,24,115,529.29,2,1,3,6,Diamond
4192,18044.0,4,128,2085.65,1,1,1,3,Platinum
4193,18045.0,45,43,178.33999999999997,2,2,4,8,Gold
4194,18048.0,203,7,172.29000000000002,4,4,4,12,Bronze
4195,18050.0,359,5,74.4,4,4,4,12,Bronze
4196,18053.0,66,21,297.0700000000001,3,3,3,9,Gold
4197,18055.0,7,361,6729.289999999999,1,1,1,3,Platinum
4198,18056.0,288,19,363.65,4,3,3,10,Silver
4199,18058.0,9,3,170.16,1,4,4,9,Gold
4200,18059.0,9,21,296.71,1,3,3,7,Diamond
4201,18061.0,21,46,2119.41,2,2,1,5,Platinum
4202,18062.0,173,27,720.5200000000001,4,3,2,9,Gold
4203,18064.0,133,7,814.0,3,4,2,9,Gold
4204,18065.0,5,138,2380.08,1,1,1,3,Platinum
4205,18066.0,75,10,318.0,3,4,3,10,Silver
4206,18067.0,40,37,396.33000000000004,2,3,3,8,Gold
4207,18068.0,289,1,101.69999999999999,4,4,4,12,Bronze
4208,18069.0,26,459,1994.39,2,1,1,4,Platinum
4209,18071.0,257,25,453.0,4,3,3,10,Silver
4210,18072.0,155,36,8.881784197001252e-15,4,3,4,11,Bronze
4211,18073.0,114,75,3846.74,3,2,1,6,Diamond
4212,18074.0,373,13,489.6,4,4,3,11,Bronze
4213,18075.0,23,153,2538.7200000000003,2,1,1,4,Platinum
4214,18077.0,8,223,2584.41,1,1,1,3,Platinum
4215,18078.0,217,29,336.13,4,3,3,10,Silver
4216,18079.0,45,123,3613.1499999999996,2,1,1,4,Platinum
4217,18080.0,18,2,1231.5,2,4,2,8,Gold
4218,18081.0,36,17,343.45,2,4,3,9,Gold
4219,18082.0,25,70,680.8399999999999,2,2,2,6,Diamond
4220,18084.0,16,2,87.52999999999999,1,4,4,9,Gold
4221,18085.0,330,29,689.9499999999999,4,3,2,9,Gold
4222,18086.0,274,7,101.33999999999999,4,4,4,12,Bronze
4223,18087.0,98,7,3770.12,3,4,1,8,Gold
4224,18088.0,61,37,166.02999999999997,3,3,4,10,Silver
4225,18092.0,2,90,9065.76,1,2,1,4,Platinum
4226,18093.0,93,38,2083.4199999999996,3,3,1,7,Diamond
4227,18094.0,81,70,3017.3,3,2,1,6,Diamond
4228,18095.0,312,21,580.05,4,3,3,10,Silver
4229,18096.0,11,196,849.06,1,1,2,4,Platinum
4230,18097.0,7,107,2657.4500000000003,1,1,1,3,Platinum
4231,18099.0,127,19,168.31,3,3,4,10,Silver
4232,18101.0,11,40,222.4,1,3,4,8,Gold
4233,18102.0,0,433,256438.49,1,1,1,3,Platinum
4234,18104.0,37,38,754.6400000000001,2,3,2,7,Diamond
4235,18105.0,37,18,113.48000000000002,2,3,4,9,Gold
4236,18106.0,329,37,421.9,4,3,3,10,Silver
4237,18108.0,248,19,264.65,4,3,4,11,Bronze
4238,18109.0,1,451,7877.27,1,1,1,3,Platinum
4239,18110.0,19,40,168.55,2,3,4,9,Gold
4240,18112.0,12,26,352.69000000000005,1,3,3,7,Diamond
4241,18113.0,368,1,76.32000000000001,4,4,4,12,Bronze
4242,18114.0,290,28,220.1,4,3,4,11,Bronze
4243,18116.0,67,371,1403.1100000000001,3,1,2,6,Diamond
4244,18117.0,25,72,315.65,2,2,3,7,Diamond
4245,18118.0,10,1268,5567.030000000001,1,1,1,3,Platinum
4246,18119.0,367,29,180.69999999999996,4,3,4,11,Bronze
4247,18120.0,214,17,111.14999999999999,4,4,4,12,Bronze
4248,18121.0,149,31,653.3000000000001,4,3,2,9,Gold
4249,18122.0,8,357,1793.0600000000002,1,1,1,3,Platinum
4250,18123.0,24,34,574.4399999999999,2,3,3,8,Gold
4251,18125.0,29,193,1130.1,2,1,2,5,Platinum
4252,18126.0,60,52,200.92000000000002,3,2,4,9,Gold
4253,18127.0,19,46,347.08,2,2,3,7,Diamond
4254,18129.0,243,14,112.55,4,4,4,12,Bronze
4255,18130.0,8,71,1045.7399999999998,1,2,2,5,Platinum
4256,18133.0,211,2,715.4999999999999,4,4,2,10,Silver
4257,18135.0,29,20,681.9100000000001,2,3,2,7,Diamond
4258,18136.0,63,39,761.8299999999998,3,3,2,8,Gold
4259,18138.0,295,8,152.65,4,4,4,12,Bronze
4260,18139.0,17,162,8393.220000000001,2,1,1,4,Platinum
4261,18141.0,360,1,-35.400000000000006,4,4,4,12,Bronze
4262,18142.0,151,18,1014.9,4,3,2,9,Gold
4263,18143.0,116,61,1000.1600000000001,3,2,2,7,Diamond
4264,18144.0,7,43,2888.7500000000005,1,2,1,4,Platinum
4265,18145.0,12,221,2861.55,1,1,1,3,Platinum
4266,18146.0,140,10,160.35,3,4,4,11,Bronze
4267,18147.0,45,7,179.33999999999997,2,4,4,10,Silver
4268,18149.0,50,16,612.0799999999999,2,4,3,9,Gold
4269,18150.0,32,37,566.5800000000002,2,3,3,8,Gold
4270,18151.0,134,38,653.3499999999999,3,3,2,8,Gold
4271,18154.0,3,21,399.18999999999994,1,3,3,7,Diamond
4272,18155.0,75,28,347.82,3,3,3,9,Gold
4273,18156.0,12,122,675.64,1,1,2,4,Platinum
4274,18158.0,9,35,451.75,1,3,3,7,Diamond
4275,18159.0,301,23,530.1500000000001,4,3,3,10,Silver
4276,18160.0,57,39,638.0600000000002,3,3,3,9,Gold
4277,18161.0,10,81,1612.79,1,2,1,4,Platinum
4278,18164.0,31,25,394.7,2,3,3,8,Gold
4279,18165.0,177,10,302.46000000000004,4,4,3,11,Bronze
4280,18167.0,3,43,1355.51,1,2,2,5,Platinum
4281,18168.0,176,139,1123.7399999999998,4,1,2,7,Diamond
4282,18169.0,60,9,202.65,3,4,4,11,Bronze
4283,18170.0,33,38,980.3100000000001,2,3,2,7,Diamond
4284,18171.0,58,56,1208.5100000000002,3,2,2,7,Diamond
4285,18172.0,14,197,7490.17,1,1,1,3,Platinum
4286,18173.0,86,31,2106.8400000000006,3,3,1,7,Diamond
4287,18174.0,7,1,104.0,1,4,4,9,Gold
4288,18176.0,353,33,448.65,4,3,3,10,Silver
4289,18177.0,31,74,1313.6200000000001,2,2,2,6,Diamond
4290,18178.0,113,99,1573.4099999999999,3,2,2,7,Diamond
4291,18179.0,9,90,1793.1700000000003,1,2,1,4,Platinum
4292,18180.0,4,119,1843.7500000000005,1,1,1,3,Platinum
4293,18181.0,24,41,366.84999999999997,2,3,3,8,Gold
4294,18183.0,218,44,600.5200000000001,4,2,3,9,Gold
4295,18184.0,15,1,49.8,1,4,4,9,Gold
4296,18185.0,249,17,304.25,4,4,3,11,Bronze
4297,18188.0,15,72,1998.49,1,2,1,4,Platinum
4298,18189.0,77,69,1084.3400000000001,3,2,2,7,Diamond
4299,18190.0,192,16,274.51,4,4,4,12,Bronze
4300,18191.0,261,7,207.79999999999998,4,4,4,12,Bronze
4301,18192.0,71,45,957.9699999999999,3,2,2,7,Diamond
4302,18193.0,150,18,212.95999999999998,4,3,4,11,Bronze
4303,18194.0,64,9,895.9999999999999,3,4,2,9,Gold
4304,18196.0,95,139,686.6300000000001,3,1,2,6,Diamond
4305,18198.0,4,166,5083.060000000001,1,1,1,3,Platinum
4306,18200.0,106,30,150.35,3,3,4,10,Silver
4307,18202.0,199,68,1396.9900000000002,4,2,2,8,Gold
4308,18203.0,157,19,160.42000000000002,4,3,4,11,Bronze
4309,18204.0,71,194,1960.95,3,1,1,5,Platinum
4310,18205.0,36,32,517.3599999999999,2,3,3,8,Gold
4311,18209.0,28,8,139.10000000000002,2,4,4,10,Silver
4312,18210.0,1,134,2621.38,1,1,1,3,Platinum
4313,18211.0,25,42,600.07,2,2,3,7,Diamond
4314,18212.0,326,34,216.07,4,3,4,11,Bronze
4315,18213.0,236,15,232.48000000000002,4,4,4,12,Bronze
4316,18215.0,89,13,299.34,3,4,3,10,Silver
4317,18216.0,31,26,481.74999999999994,2,3,3,8,Gold
4318,18217.0,29,31,621.7500000000001,2,3,3,8,Gold
4319,18218.0,206,23,606.2200000000001,4,3,3,10,Silver
4320,18219.0,2,115,2019.77,1,1,1,3,Platinum
4321,18220.0,219,4,297.78000000000003,4,4,3,11,Bronze
4322,18221.0,22,65,1033.3100000000002,2,2,2,6,Diamond
4323,18222.0,92,19,443.0,3,3,3,9,Gold
4324,18223.0,1,299,6315.2300000000005,1,1,1,3,Platinum
4325,18224.0,263,10,158.95000000000002,4,4,4,12,Bronze
4326,18225.0,3,284,5356.86,1,1,1,3,Platinum
4327,18226.0,38,245,5192.1,2,1,1,4,Platinum
4328,18227.0,217,5,93.75,4,4,4,12,Bronze
4329,18228.0,50,32,769.2,2,3,2,7,Diamond
4330,18229.0,11,164,7276.9,1,1,1,3,Platinum
4331,18230.0,9,89,2716.6,1,2,1,4,Platinum
4332,18231.0,192,125,2054.67,4,1,1,6,Diamond
4333,18232.0,81,40,582.47,3,3,3,9,Gold
4334,18233.0,325,1,440.0,4,4,3,11,Bronze
4335,18235.0,71,104,1796.4800000000002,3,1,1,5,Platinum
4336,18236.0,29,49,882.24,2,2,2,6,Diamond
4337,18237.0,2,61,987.1000000000001,1,2,2,5,Platinum
4338,18239.0,218,88,1561.6100000000001,4,2,2,8,Gold
4339,18240.0,46,6,422.58000000000004,2,4,3,9,Gold
4340,18241.0,9,105,2058.09,1,1,1,3,Platinum
4341,18242.0,72,78,2232.4900000000002,3,2,1,6,Diamond
4342,18245.0,7,177,2507.56,1,1,1,3,Platinum
4343,18246.0,23,4,596.0999999999999,2,4,3,9,Gold
4344,18248.0,113,49,783.02,3,2,2,7,Diamond
4345,18249.0,17,8,95.34,2,4,4,10,Silver
4346,18250.0,301,22,342.92,4,3,3,10,Silver
4347,18251.0,87,16,4314.72,3,4,1,8,Gold
4348,18252.0,50,94,518.27,2,2,3,7,Diamond
4349,18255.0,89,6,103.3,3,4,4,11,Bronze
4350,18256.0,354,4,-50.1,4,4,4,12,Bronze
4351,18257.0,39,123,2265.3800000000006,2,1,1,4,Platinum
4352,18259.0,24,42,2338.6000000000004,2,2,1,5,Platinum
4353,18260.0,172,139,2580.1499999999996,4,1,1,6,Diamond
4354,18261.0,43,21,324.24,2,3,3,8,Gold
4355,18262.0,140,13,149.48,3,4,4,11,Bronze
4356,18263.0,23,62,1211.08,2,2,2,6,Diamond
4357,18265.0,72,46,801.5100000000001,3,2,2,7,Diamond
4358,18268.0,134,2,0.0,3,4,4,11,Bronze
4359,18269.0,358,8,138.9,4,4,4,12,Bronze
4360,18270.0,38,13,238.95000000000005,2,4,4,10,Silver
4361,18272.0,2,170,3064.78,1,1,1,3,Platinum
4362,18273.0,2,3,204.0,1,4,4,9,Gold
4363,18274.0,17,22,-1.7763568394002505e-15,2,3,4,9,Gold
4364,18276.0,21,16,323.36,2,4,3,9,Gold
4365,18277.0,58,9,97.63000000000001,3,4,4,11,Bronze
4366,18278.0,73,9,173.89999999999998,3,4,4,11,Bronze
4367,18280.0,277,10,180.6,4,4,4,12,Bronze
4368,18281.0,180,7,80.82,4,4,4,12,Bronze
4369,18282.0,7,13,176.6,1,4,4,9,Gold
4370,18283.0,3,721,2045.53,1,1,1,3,Platinum
4371,18287.0,42,70,1837.2800000000002,2,2,1,5,Platinum
